reference	predicted
السَّلَامُ عَلَيكُم	السَّلَام عَلِيْكُمْ
السَّلَامُ عَلَيكُم وَرَحمَةُ اللهِ وَبَرَكَاتُه	السَّلَامْ عَلَيْكُمْ وَرْحْمَة الله وَبْرَكَاته
تِسمَحلِي	تَسْمَحْلِي
تِسمَحلِي	تَسْمَحْلِي
تِسمَحلِي	تَسْمَحْلِي
لَو تَكَرَمت	لَو تَكْرَمْتْ
لَو سَمَحت عَايز	لو سَمَحْتْ عَايِزْ
أنَا عَايِز لَو سَمَحت	اَنَا عَايْزْ لو سَمَحْتَ
لَو سَمَحت جِبلِي	لو سَمْحْتْ جِبْلِي
عَندَك حَجز	عَنْدَكْ حَجِّزْ
اِستَنَّا شِوَيَّه	اِسْتْنَا شَوِيهْ
هَستَنَّى هِنَا	هَسَتْنَى هَنَا
المََطعَم بِيئفِل إِمتَه	الْمَطْعَم بِيِيْفِلْ اِمْتَهُ
المََطعَم بِيفتَح إِمتَه 	الْمَطْعَم بِيفْتَحْ اَمْتِه
المََطعَم دَه بِيِعمِل فِطَار	الْمَطْعِم دَه بِيعْمِلْ فَطَارْ
هُوَّ المََطعَمدَه بِيِعمِل غَدَا وِعَشَا 	هُو الْمَطْعَمْدهْ بِيَعْمَل غَدَا وَعَشَا
هُوَّ المَطعَم دَه بِيِعمِل عَشَا 	هُو الْمَطْعِم دَهْ بِيَعْمَلْ عَشَا
الصُّوت مُش وَاضِح	الصَّوْتْ مِشْ وَاضِح
مُش سَمعَك	مش سِمْعَكْ
أَنَا مُش سَامِع صُوتَك	اَنَا مِشْ سَامَعْ صُوتَكْ
صُوتَك وَاطِي	صُوْتِكْ وَاطِي
أَتمَنَّى التَّصحِيح	اَتْمَنى الْتَصْحِيْحْ
لَو سَمَحت عَدِّلهَالِي	لو سَمْحْتْ عَدَلْهَالِي
عَيزَك تِعِيد عَلَيَّ المَعلُومَات إِللِّي أُلتَهَا	عَيْزَكْ تَعِيدْ عَلِي الْمَعْلُومَاتْ اللِي التهَا
عَايِز أَتكَلَّم مَعَ المَسؤُول	عَايِزْ اَتْكَلِم مَعْ الْمَسوول
مِين المَسؤُول	مِيْنْ الْمَسوول
مُش فَاهِم إِنتَ بِتئُول اِيه	مِشْ فَاهِمْ اِنْتِ بِتيول اَيْه
مُش فَهِمنِي	مِشْ فَهْمْنِي
مَفهِمتِش اِللِّي أَنَا عَيزُه	مَفْهَمْتِشْ الْلِي اَنَا عَيْزْهْ
مَا فهِمتِنِيش	مَا فَهَمْتِنِيشْ
مُش فَهمِك	مش فَهَمْكْ
مُش فَهمَه إللِّي بَئُولُه	مُشْ فَهْمْهُ الْلِّي بِيُولْه
مَافِهِمتِيش اَنَا عَايِز إِيه	مَافْهَمْتِيشْ اَنَا عَايْز اِيه
مَافِهِمتِنِيش	مَافْهَمْتِنِيشْ
هُوَّ فِيه مَكَان لِلِّي مَا بِيدَخَّنُوش	هُو فِيهْ مَكَان لِلِي مَا بِيدْخْنُوشْ
مَعَندُكُوش قِسم لِلِّي مَا بِيدَخَنُوش	مَعْنْدْكُوشْ قَسْمْ لِلِي مَا بِيْدْخْنُوشْ
أنا عَايِز المَكَان المُخَصَّص للِّي مَا بِيدَخَّنُوش	اَنَا عَايِزْ الْمَكَان الْمَخَصْصْ لِلِي مَا بِيْدْخْنُوشْ
فَين المَكَان المُخَصَص للِّي مَا بِيدَخَّنُوش	فِينْ الْمَكَان الْمَخَصِصْ لِلِي مَا بِيْدْخْنُوشْ
فِين المَكَان المُخَصَّص لِلمُدَخِّنِين	فِينْ الْمَكَان الْمَخْصِصْ لِلْمُدْخنِينْ
مَعلِش أَنَا آسِف	مَعْلِشْ اَنَا اَسْفْ
مَعلِش أَنَا آسِف	مَعْلَشْ اَنَا اَسْفْ
لَو تَكرَّمت	لو تَكْرَمْتْ
تِسمَحلِي	تَسْمَحْلِي
اَيوَه	اَيوهْ
لَأَّه	لَاهْ
حَاضِر	حَاضِر
طَيِّب	طِيْبْ
شُكرًا	شَكْرَا
شُكرًا	شَكْرَا
شُكراً	شَكْرَا
مُش عَايِز	مش عَايِزْ
مُش آدِر	مِشْ اَدْرْ
مُش عَايِز	مش عَايِزْ
أَنَا آسِف	اَنَا اَسْفْ
سَامحنِي	سَامْحْنِي
سَامحِينِي	سَامْحِينِي
أَنَا آسِف جِداً	اَنَا اَسْفْ جِدَا
إِيه نُوع البُهَرَات إللِّي فِي السَّلَطَه	اَيْهْ نُوعْ الْبِهْرَات الْلِي فِي السُّلْطه
إِيه هِّيه أنوَاع السَّلَطَات عَندُكُم	اَيْه هِيهْ انْوَاعْ السُلْطَات عَنْدْكُم
إِيه أنوَاع السَّلَطَات اللِّي بِتأدِّمُوها	اَيْه اَنْوَاعْ السُّلْطَاتْ الْلِّي بِتَادْمُوهَا
لو سَمَحتِ عَايِز أَهوَه	لو سَمْحْتْ عَايِزْ اَهُوه
عَايِز فِنجَان أَهوَه	عَايِزْ فِنْجَانْ اَهوهْ
هَاتِ الأَهوَه الاَوَّل	هَاتْ الْاَهوهْ الْاَوَّل
هَاتِيلِي الأَهوَه	هَاتِيلِي الْاَهوه
لَو سَمَحتِي عَايِز شَاي	لو سَمْحْتِي عَايِزْ شَايْ
عَايِز فِنجَان شَاي الأَوَّل	عَايِزْ فِنْجَانْ شَايْ الاَوَل
اعمِليلنَا الشَّاي بَعدِ العَشَا	اَعْمَلِيلْنَا الْشَايْ بَعَدْ الْعَشَا
لَو سَمَحتِ عَايِز الاَكل دِلوَئتِي	لو سَمْحْتْ عَايِزْ الْاَكْل دَلوِيتِي
هَاتِ السَّلَطَه أَبل الَأَكل	هَاتْ السَّلْطهْ اَبْلْ الْاَكُل
عَايِز إسبِرَايِت	عَايِزْ اِسَّبَرَايِت
عاَيِز كُوكَاكولَا	عَايِزْ كوكَاكُولَا
هَاتِلنَا بِبسِي	هَاتْلْنَا بِبْسِي
عَايِز شوَيَّة وَأت لِتَجهِيز الاَكل	عَايِزْ شْوََيَّة وَاتْ لِتْجْهِيز الْاَكَلْ
عَايِز المِنيُو	عَايِزْ الْمَنِيو
أَنَا لِسَّه مُش جَاهِز لِطَلَبِك دِلوَئتِي	اَنَا لِسْهْ مُشْ جَاهِزْ لِطْلَبْكْ دَلْوِيتِي
لِسَّه مَخَتِّش قَرَار	لِسهْ مُخْتِشْ قْرَارْ
أدِّينِي شوَية وَئت عَلَشَان أقَرَّر	اَدِينِي شُويَّة وَيْت عَلْشَانْ اَقْرَرْ
عَايِز شويِّة وَئت عَلَشَان أقَرَّر	عَايِزْ شْوََيَّة وَيتْ عَلْشَانْ اَقْرَر
إِيه أَنوَاع الأَكَل عَندُكُو	اَيْهْ اِنْوَاعْ الْاَكِل عَنْدْكُو
إِيه رَايَك نَاكُل إيه	اَيْه رَايِكْ نَاكِلْ اَيْه
الفِطَار	الْفَطَارْ
شُوربَة خُضَار مَع زِيت زَيتُون	شورْبَة خَضَارْ مَعْ زِيْتْ زِيتُونْ
عَسَل وِجِبنَه وِمُرَبَّى الفَرَولَه	عَسَلْ وَجْبْنِه وْمَرْبَى الْفُرُوله
حَلَاوَة طِحِينِيَّة مَعَ زِبَدَةِ الفُول السُّودَانِي	حَلَاوَة طَحِينِيَة مَعْ زِبْدَة الفُولْ السُّودَانِي
إِيه رَايَك نَاكُل إيه	اَيْه رَايِكْ نَاكِل اَيَه
عَندُكُو شوربِة اِيه النِهَردَه	عَنْدْكُو شُورْبَة اَيْهْ النّهْرْده
إِيه طَبَأ إِنَّهردَه	اَيْه طَبَّا اِنْهَرْدَه
فِرَاخ مَشوِيَّه	فَرَاخْ مَشوِيه
لَحمَهَ مَعَ رُّز	لَحَمْهْ مَعْ رَزْ
رُزّ و لَحمه	رَزْ وْ لِحَمْهْ
رُزُّ وفِرَاخ	رَز وَفْرَاخْ
مَشوِيَّات مِشَكِّلَه	مْشوِيَاتْ مَشْكِلْه
أَكَلات بَحرِيَّة	اَكْلَاتْ بِحَرِيَّة
بِالنِّسبَالِي بَفَضَّل الاَكل النَّبَاتِي	بِالْنِّسْبَالِي بِفَضْلْ الْاَكْل الْنِبَاتِي
صِحَّة وِعَافيَة	صَحَّة وَعَافِيَة
عَايِز خُبز	عَايْزْ خَبْز
عِيش كَمَان	عَيْشْ كَمَانْ
تِنصَحنَا بِإِيه	تَنْصِحْنَا بَايِهْ
تِنصَحِينِي بِإِيه	تَنْصَحِينِي بَايْهْ
إِيه أحسَن وَجبَه عَندُكُو	اَيْهْ اَحْسَنْ وَجْبَهْ عَنْدْكُو
أحسن الوَجَبَات عَندُكُو	اَحْسَنْ الْوَجْبَاتْ عَنْدْكُو
هَاتِ السَّلَطَات وبَعدِين هَات الاَكل	هَاتْ السُّلْطَاتْ وَبَعْدِينْ هَاتْ الاَكُلْ
عَندُكُو بُوفِيه مَفتُوح	عَنْدْكُو بِوفِيهْ مَفْتُوح
إيه الأَنوَاع إللِّي بِتئَدِّمُوهَا فِي البُوفِيه المَفتُوح	اَيْهْ الْاَنْوَاع الْلِي بِتيدْمُوهَا فِي الْبُوفِيه الْمَفْتُوح
هُوَّ كُلِّ الأنوَاع حَلَال	هُو كُلْ الْاَنْوَاع حَلَال
إِيه أنوَاع العَصَائِر إللِّي عَندُكُو	اَيْه اَنْوَاعْ الْعَصَايِر الْلي عَنْدْكُو
عَصِير بُرتُئَان	عَصِيْرْ بِرْتَيَانْ
فُول وعَدس	فَولْ وَعَدْسْ
عِيش فِينُو وعِيش عَادِي	عَيْشْ فِينُو وَعِيْشْ عَادِي
أَربَعه تَمِيس	اَرْبَعُه تْمِيْسْ
فُول وِمطَبَّأ	فَوَّلْ وَمْطَبَا
عَصِير مِشَكِّل	عَصِيْرْ مَشَكِلْ
عَصِير فَوَاكِهَ مشَكَّلَة	عَصِيرْ فَوَاكِه مُشْكِلَة
عَصِير بُرتُآن وِلَيمُون	عَصِيرْ بَرْتَانْ وَلِيْمُونْ
تَلَت أَرغِفِة	تِلْتْ اَرْغَفَة
رِغِيفِين عِيش	رَغِيْفِين عَيْش
رِغِيف عِيش	رَغِيفْ عَيْشْ
سِكِّينَه	سَكِينْه
شَوكَه	شُوكَه
مَعلَأَه	مَعْلَاهْ
مَعلَأه صُغَيَّرَه	مَعْلَاهْ صَغيْرْه
طَبَأ	طَبَا
طَبَأ كِبِير	طَبَا كْبِيرْ
طَبَأ صُغَيَّر	طِبَا صَغِيرْ
أَنَا جَعَان	اَنَا جَعَانْ
أَنَا عَطشَان	اَنَا عَطَشَانْ
عَايِز مَيَّه	عَايْزْ مِيهْ
حُمُّص	حَمَّصْ
كَبَاب	كَبَابْ
أورَاك	اورَاكْ
شُوربَة عَدس	شورْبَة عَدْسْ
شُوربَة خُضَار	شورْبَة خَضَارْ
شُوربَة فِرَاخ	شورْبَة فَرَاخْ
شُوربَة حَرِيرَة	شورْبَة حَرِيرَة
عَسَل	عَسَلْ
جِبنَه	جَبْنَهُ
سَلَطَات	سُلْطَاتْ
حَلَاوَه	حَلَاوْه
الأَكل مَكَنش حِلو	الْاَكْلْ مْكْنْشْ حَلُّوْ
العَشَا كَان لَذِيذ	الْعَشَا كَان لِذِيذْ
دَا مِن افضَل الاَطبَاء إللِّي دُئتَهَا	دَا مِنْ اَفْضَل الْاَطْبَاء الْلِي دِيتْهَا
كَان أَحسَن طَبَأ دُئتُه	كَان اَحْسَنْ طَبَا دِيْتَه
الطَّبَأ دَا لَذِيذ	الطَبَا دَا لِذِيْذْ
الطَّبَأ دَا مَكَنشِ بِالمَستَوَى المَطلُوب	الطَبَا دَا مَكْنِشْ بِالْمُسْتَوى الْمَطْلُوبْ
المَطعَم دَا رَائِع	الْمَطْعَم دَا رَايَعْ
المَطعَم مِن أَفضَل المَطَاعِم إللِّي زُرتَها	الْمَطْعَم مِنْ اَفْضَل الْمَطَاعَم الْلِّي زَرْتَهَا
تَعَامُلكُم كَان رَائِع	تَعَامْلْكُمْ كَان رَايَع
مُوَظَّف الاستِئبَال كَان لَطِيف	مَوَظْفْ الْاِسْتِيبَال كَان لِطِيفْ
المَطعَم دَه مُش مُرِيح	الْمَطْعِم دَه مِشْ مَرِيحْ
صُوت المُوسِيقَى عَالِي جَدَّاً	صَوَّتْ الْمُوْسِيقَى عَالِي جِدَا
الجَوّ رَائِع فِي المََطعَم	الْجَوْ رَايِعْ فِي الْمَطْعَمْ
بَحِب المَطعَم ده	بِحِبْ الْمَطْعِمْ دَهْ
رَائِحَةُ الدُّخَّانِ مُزعِجَه	رَايْحَة الْدَّخَانْ مَزْعَجْه
مُمتَاز	مُمْتَازْ
مُتَوَسِّط	مَتْوَسْطْ
رَائِع	رَايْعْ
مُش جَيّد	مش جِيدْ
مُش مُرضِي	مش مَرْضِي
مُش مُرِيح	مِشْ مَرِيحْ
فِين الحَمَّامَات	فِينْ الْحَمَامَاتْ
فِين الحَمَّام	فِينْ الْحَمَام
عَايِز دُورة المَّيه	عَايْزْ دُورَة الْمِيهْ
مُمكِن اَغسِل إِيدِي فِين	مُمْكِنْ اَغْسَلْ اَيْدِي فِينْ
عَايِز آخُد الأكل بَرَّه المَطعَم	عَايِزْ اَخَدّ الْاَكْل بَرَه الْمَطْعَم
مُمكِن آخُد دَه بَرَّه المَطعَم	مُمْكِنْ اَخَد دَهْ بَرَه الْمَطْعَمْ
اِتفَضَّلِ الطَّلَب	اِتْفَضَل الطَّلَب
هاخُد البَائِي مِ الاَكِل مَعَايَا	هَاخِد الْبَايِي مِ ْالْاَكْل مَعَايَا
عَايز طَرَبِيزه لِشَخصِيِن	عَايْزْ طَرْبِيزُه لِشْخْصِينْ
أَنَا حَاجِز	اَنَا حَاجِزْ
عَندِى حَجز فى المَطعَم	عَنْدَى حَجْزْ فَى الْمَطْعَم
عَايِز طَرَبِيزَه لأَربَع أَشخَاص	عَايْزْ طَرْبِيزُه لِاَرْبَعْ اَشْخَاصْ
عَايِز طَرَبِيزَه لِتَلَت أشخَاص	عَايِزْ طَرْبِيزُهْ لِتَلْتْ اَشْخَاصْ
مَندِيل	مِنْدِيلْ
مَنَادِيل	مَنَادِيلْ
أَطبَاء	اَطْبَاءْ
طَبأ كِبِير	طِبَا كْبِيرْ
طَبَأ صُغَيَّر	طَبَا صَغِيرْ
مَعلَئَه	مَعَلِيهْ
مَعلَئَه كِبِيرَه	مَعْلِيهْ كَبِيرَه
مَعلئه صُغَيَّرَه	مَعْلِيهْ صَغيْرْه
مَندِيل لِلمَسح	مِنْدِيل لِلْمَسْح
أَطبَاء	اَطْبَاءْ
طَبَأ	طَبَا
كُبَّايِه	كَبَايِهْ
تَلَت اطبَّاء	تَلْتْ اَطْبَاء
مَعَلئتِين	مَعْلِيتِين
طَبَأ كِبِير ومَعلَئَه	طَبَا كْبِيرْ وَمَعْلِيهْ
طَرَبِيزَه كِبِيرَه	طَرْبِيزَهْ كَبِيرَهْ
طَرَبيزَه صُغَيرَه	طَربِيزَه صَغِيْرَه
هَات الحِسَاب	هَاتْ الْحَسَاب
عَايِز الحِسَاب	عَايْزْ الْحَسَاب
فِين الحِسَاب	فِينْ الْحَسَاب
فِين حِسَاب الأكل	فِينْ حِسَابْ الاَكُل
فَاتُورَة لِكُل شَخص لَو سَمَحت	فَاتُورَة لكلْ شَخْص لو سَمَحَتْ
مُمكِنُ الإِيصَال لَو سَمَحتِي	مُمْكِنْ الْاَيْصَال لو سْمَحْتِي
فِيه خَطَأ فِي الفَاتُورَه	فِيهْ خَطَّا فِي الْفَاتُورَه
فَيِن الفَاتُورَه بِالتَّفصِيل	فِينْ الْفَاتُوره بِالْتَّفْصِيل
مَطَلَبتِش دَه	مَطْلِبْتْشْ دَه
مَطَلَبتِش الصَّنف دَه	مَطْلْبَتْشْ الصَّنْفْ دَهْ
خَلِّي البَائِي عَلَشَانَك	خَلِّي الْبَايِي عَلَشَانَكْ
الغَدَا بِكَام	الْغَدَا بِكَام
المَجمُوع كُلُّه كَام	الْمَجْمُوعْ كُله كَام
العَشَا بِكَام	العَشَا بِكَامْ
هُوَّ البُوفِيه المَفتوح بِكَام	هُو الْبُوفِيه الْمَفْتُوح بِكَام
هُوَّ فِيه رُسُوم لِلخِدمَه	هُو فِيهْ رَسومْ لِلْخَدْمْهْ
بِتشتَغَلُو يُوم الخَمِيس	بِتْشْتَغْلُو يومْ الْخَمِيسْ
هِوَّالمَطعَم بِيفتَح يَوم الجِمعَه	هُوالْمَطْعِم بِيفْتَح يُومْ الْجُمْعُه
السَّلَامُ عَلَيكُم وَرَحمَةُ اللهِ وَبَرَكَاتُه	السَّلَامْ عَلَيْكُمْ وَرْحْمَة الله وَبْرَكَاتُه
السَّلَامُ عَلَيكُم	السَّلَامْ عَلِيْكُمْ
السَّلَامُ عَلَيكُم وَرَحمَةُ الله	السَّلَامْ عَلَيْكُمْ وَرْحْمَة الله
مَسَاء الخِير	مَسَاء الْخَيْر
صَبَاح الخِير	صَبَاح الْخَيْرْ
مَسَاء الخَيرَات	مَسَاء الْخَيْرَاتْ
أَنَا حَاجِز	اَنَا حَاجِزْ
عَندِي حَجز فِي الفُندُء دَا	عَنْدِي حَجْزْ فِي الْفِنْدِءْ دَا
حَجَزت الغُرفَه رَقم	حَجَزَت الْغَرْفه رَقَمْ
غُرفِتِي رَقم	غَرفتِي رَقَمْ
غُرفَة لِشَخص وَاحِد	غُرْفَة لِشْخْصْ وَاحِد
غُرفَة لِشَخصَين	غُرْفَة لِشْخصِينْ
غُرفَة لِتَلَت أَشخَاص	غُرْفَة لِتْلْتْ اَشْخَاصْ
عَايِز غُرفَه لِشَخص وَاحِد	عَايْزْ غَرْفِه لِشْخْصْ وَاحِد
عَايِز جِنَاح عَائِلِي	عَايِزْ جِنَاحْ عَايْلِي
بَدَوَّر عَلَى شَأَّه	بِدُور عَلَى شَاهْ
أُوضه بِسرِير مُزدَوَج	اَوْضَهُ بِسْرِير مَزْدَوج
أُوضه بِسرِيرِين	اَوْضَهُ بِسْرِيرِين
جِنَاح خَاصّ مَعَ حَمَّامِين	جِنَاح خَاصْ مَعْ حَمَامِيْن
تَلَت حَمَّامات	تَلْتْ حَمَامَاتْ
أَربَع حَمَّامات	اَرْبَعَ حَمَامَاتْ
جِنَاح خَاصّ مَعَ مَجلِس وغُرفَة لِاستِئبَال الضُّيُوف	جِنَاحْ خَاصْ مَعْ مَجْلِسْ وَغْرْفَة لِاَسْتِيبَال الضُّيوفْ
تَلَت غُرَف نُوم مَعَ حَمَّامين	تِلْتْ غَرَفْ نُومْ مَعْ حَمَامِين
غُرفِتِين نُوم مَعَ حَمَام	غَرفْتِينْ نُومْ مَعْ حَمَام
الصُّوت مُش وَاضِح	الصوْت مِشْ وَاضِح
مُش سَمعَك	مَشْ سَمْعَكْ
مُش آدِر اسمَع صُوتَك	مِشْ اَدْر اَسْمَعْ صُوْتَكْ
عَايِز اَتكَلِّم مَعَ المَسئُول	عَايِزْ اَتْكَلْمْ مَعْ الْمَسْيول
عَايِز أتكَلِّم مَعَ وَاحِد تَانِي	عَايِزْ اَتْكَلْم مَعْ وَاحِد تَانِي
يَارِيت التَّصحِيح	يَارِيتْ الْتَصْحِيح
أَرجُو التَّعدِيل	اَرْجُو الْتَعْدِيل
بَدَوَّر عَلَى فُندُء	بِدُور عَلَى فَنْدْءْ
أَنَا بَدَوَّر عَلى فُندُء	اَنَا بِدور عَلَى فَنْدَءْ
مُمكِن تِسَاعِدنِي أَدَوَّر عَلى فُندُء	مُمْكِنْ تِسَاعِدْنِي اَدورْ عَلَى فَنْدِءْ
لَو سَمَحت مُمكِن تِعِيد عَلَيَّ المَعلُومات إللِّي أَنَا اُلتَهَا	لو سَمْحْتْ مُمْكِنْ تَعِيدْ عَلِي الْمَعْلُومَاتْ الْلِي اَنَا الْتَهَا
مُش فَاهِم إللِّي أَنَا بَئُولُه	مُشْ فَاهَمْ الْلِّي اَنَا بِيُوله
مَفهِمتِش إللِّي أنَا عَايزُه	مَفْهَمْتْشْ الْلِي اَنَا عَايِزَهْ
مَفهِمتِنِيش	مَفْهَمِتِنِيشْ
مُش فَاهِم إللِّي بِتَئُولِيه	مِشْ فَاهِمْ الْلِّي بِتيولِيهْ
مُشَ فَاهِمه إللِّي أَنَا بَئُولُه	مُشْ فَاهْمهْ الْلِي اَنَا بِيُوله
مَفهِمتِيش إللِّي أَنَا عَايزُه	مِفْهَمْتِيشْ الْلِي اَنَا عَايْزَه
مَفهِمتِينِيش	مَفْهَمْتِينِيشْ
جِنَاح	جِنَاحْ
شَئَّة	شِيَة
غُرفَة	غُرْفَة
غُرفِتِين	غَرفَتِينْ
تَلَت غُرَف	تِلْتِ غَرَفْ
حَمَّام	حَمَامْ
دُورِة مَيَّه	دورَة مِيهْ
مَطبَخ	مَطَبْخْ
صَالَة	صَالَة
مَمَرّ	مَمَّرْ
سِرِير	سْرِيرْ
طَرَبِيزَه	طَرْبِيزْه
عَايِز خَدَمَات غَسِيل الهِدُوم	عَايْزْ خَدْمَاتْ غَسِيلْ الْهَدُوم
تَحوِيلِة مَغسَلَة المَلَابِس	تَحَوِيلَة مَغْسِلَّة الْمَلَابِس
خَدَمَات تَنظِيف الغُرَف	خَدَمَاتْ تَنْظِيف الْغَرَفْ
مَسئُول تَنظِيف الغُرَف	مَسِيولْ تَنْظِيف الْغَرَفْ
عَايِز الغُرفَه	عَايْزْ الْغَرْفه
تَحوِيلِة نَظَافِةَ الغُرَف	تَحَوِيلَة نِظَافَة الْغَرَفْ
كَم رَقَم تَحوِيلِة	كُمْ رَقَمْ تَحَوِيلَة
مُمكِن تِدِّينى رَقَمَ تَحوِيلِة مَغسَلِة المَلَابِس	مُمْكِنْ تْدِينَى رَقَمْ تَحْوِيلَة مَغْسِلَة الْمَلَابِس
عَايِز رَقَم تَحويلِه خَدَمَات الغُرَف	عَايِزْ رَقَّمْ تَحَوِيلَه خَدَمَاتْ الْغَرَفْ
مِين هُوَّه المَسئُول عَن	مِيْنْ هُوهْ الْمَسْيولْ عَنْ
مِين المَسئُول عَن	مِيْنْ الْمَسْيولْ عَنْ
خَدَمَات الغَسِيل	خَدَمَاتْ الْغَسِيلْ
الغَسَّالَة	الْغَسَالَة
مَغسَلِة المَلَابِس	مَغْسِلَة الْمَلَابِس
المَطعَم	الْمَطْعَمْ
البَنك	الْبَنْكْ
السُوء	السُّوءْ
السُّوبَر مَاركِت	السُّوبْر مَارْكِتْ
الحَمَام	الْحَمَام
الحَمَّام	الْحَمَام
خَدَمَاتُ الغُرَف	خَدَمَاتْ الْغَرَفْ
هُوَّ فِيه حَمَّام جَاكُوزِي	هُو فِيهْ حْمَام جَاكُوزِي
هُوَّ فِيه حَمَّام بُخَار	هُو فِيهْ حَمَام بِخَارْ
عَايِز حَمَّام بُخَار	عَايِزْ حَمَام بِخَارْ
هُوَّ فِيه مَسبَح فِي الفُندُء	هُو فِيهْ مَسْبَحْ فِي الْفَنْدِءْ
لَو سَمَحت هُوَّ فِينِ المَسبَح	لو سَمْحْتْ هُو فِينْ الْمَسْبَح
عَايِز أَسبَح	عَايْزْ اِسْبَحَ
فِين حَمَّام السِّبَاحَة	فِينْ حَمَام الْسِّبَاحَة
هُوَّ فِيه مَسبَح خَاصّ بالاَطفَال	هُو فِيهْ مَسْبَح خَاصْ بِالْاَطْفَال
مَسَابِح لِلأَطفَال	مَسَابِحْ لِلْاَطْفَال
إِيه أَنوَاع المَطَاعِم المَوجُودَه فِي الفُندُء	اَيْهْ اَنْوَاعْ الْمَطَاعِمْ الْمَوْجُوده فِي الْفَنْدِءْ
هُوَّ فِيه مَطَعَم بَحرِي	هُو فِيهْ مَطْعَمْ بِحْري
مَطَاعِم صِينِيَّة	مَطَاعِم صَيْنِيَّة
مَطَاعِم لِلأَكل الحَلَال	مَطَاعِمْ لِلْاَكِل الْحَلَال
هُوَّ جَمِيع ألاَصنَاف حَلَال	هُو جَمِيعْ الْاَصْنَاف حَلَال
هُوَّ فِيه أَسوَاء جُوَّه الفُندُء	هُو فِيهْ اَسْوَاء جُوهْ الْفَنْدِءْ
إِيه أَأرَب مَركَز للتَّسَوُّق	اَيْهْ ااْرَبْ مَرْكْز لِلْتَّسَوْقْ
مَرَاكِز للتَّسوِيق أُرَيبَة مِن الفُندُء	مَرَاكِزْ لِلْتَسْوِيقْ اَرِيبَة مِنْ الْفَنْدِءْ
إِيه أأرَب مَرَاكِز التَّسَوُّق للفُندُء	اَيْهْ اارَبْ مَرَاكِزْ التَّسَوْق لِلْفَنْدِءْ
أأرَب المَطَاعِمَ لِلفُندُء	اَاْرَبْ الْمَطَاعِم لِلْفَنْدِءْ
هُوَّ فِيه صَرَاف آلي	هُو فِيهْ صَرَافْ اِلْي
عَايز صَرَّاف آلِي	عَايْزْ صَرَافْ اِلْي
هُو فِيه عَندُكُم مَسَاج	هُو فِيهْ عَنْدْكُم مَسَاج
مَسَاج لِلضَّهَر	مَسَاج لِلْضَّهَرْ
عَايِز المَسَاج	عَايْزْ الْمَسَاج
مَسَاج	مَسَاج
مَسبَح	مَسْبَحْ
قَاعَة	قاعَة
فُندُء	فِنْدْءْ
صَرَّاف	صَرَاف
حَدِيقَة	حَدِيْقَة
بَهو	بِهُو
مَركَز تَسَوُّء	مَرْكَز تَسوْءْ
حَدِيقَة عَامَّة	حَدِيقَة عَامَة
الّليلة بِكَام	اللِيلَة بِكَام
كَم إِجمَالِيّ الفَتُورَة	كُمْ اِجْمَالِي الْفَتورَة
إِجمَالِيّ الإِقَامَة	اَجْمَالِي الْاَقَامَة
اِديِنِي الفَتُورَةَ مِن فَضلِك	اَدِينِي الْفِتورَة مِنْ فَضْلِكْ
هِو مُمكِن ادفَع كَاش	هُو مُمْكِنْ اَدْفَعْ كَاشْ
عَايِز أَدَفع كَاش	عَايِزْ ادْفَعْ كَاشْ
هُو اِنتُوا بِتئبَلُو الشِّيكَات	هُو اِنْتُوا بِتِيبْلُو الْشِّيْكَاتْ
هُو مُمكِن أَدفَع بِشِّيك	هُو مُمْكِنْ اَدْفَعْ بِشِيكْ
شِّيك مُصَدَّق	شِيكْ مَصْدِقْ
هَدّفَع بِالبِطَائةِ الائتِمَانِيَّة	هَدَفَعْ بِالْبْطَايَة الْاَيْتِمَانِيَة
هَحَاسِب بِالفِيزَا	هَحَاسِب بِالْفِيزَا
هُوَّ دَا شَامِل كُل مَصَارِيف الِاقَامَه	هُو دَا شَامِل كُلْ مَصَارِيفْ الْاَقَامِه
هُوَّ إِنتَ ضِفت حِسَاب الوَجَبَات	هُو اِنْتِ ضَفْتْ حَسَاب الوَجْبَاتْ
عَايِز فَتُورَه لِوَحدَهَا	عَايِزْ فَتوره لِوَحْدَهَا
كُل فَتُورَه لِوَحدَهَا	كُلْ فِتورهْ لِوَحْدهَا
عَايِز الِايِصَال لَو سَمَحت	عَايِزْ الْاَيْصَال لو سَمَحْتْ
لَو سَمَحت أَدِّينِي الفَوَتِير كَاملَه	لو سَمَحْتْ اَدِينِي الْفُوتِير كَامْلْهُ
أدِّينِي الإِيصَال	اَدِينِي الْاَيْصَال
فَاتُورَة	فَاتُورَة
شِيك	شِيكْ
كَاش	كَاشْ
صَرَّاف	صَرَاف
بِطَاقَة	بِطَاقَة
كَاش	كَاشْ
مَاستَر كَارد	مَاسْتِرْ كَارْد
فِيزَا كَارد	فِيزَا كَارِدْ
مَاستَر كَارد	مَاسْتِرْ كَارْد
أَمرِيكَان إِكسِبرِس	اَمْرِيكَان اَكْسبْرِس
فِيزَا دِبِت	فِيزَا دِبْتْ
وَصل	وَصَلْ
جَدوَل مَوَاعِيِد الرَّحَلَات	جِدوَّل مَوَاعِيْدْ الرَحْلَات
عَايِز أَعرَف مَواعِيِد رَحَلَات المُغَادره	عَايِزْ اَعْرَف مَوَاعِيْدْ رَحَلَاتْ الْمَغَادِره
عَايِز أَسَافِر مِن الرِيًاض إِلى	عَايِزْ اِسَافِر مِنْ الرِيَاضْ اَلَى
عَايِز أَسَافِر مِن	عَايْزْ اَسَافِرْ مِنْ
عَايِز أَسَافِر إِلى	عَايْزْ اِسَافِرْ اِلَى
إِمتَه هَتِوصَل الرِحلَه	اَمْتَهْ هَتْوَصِلْ الرَّحَله
كَام عَدَد الرَحَلاَت إِلِّي جَايَّه	كَام عَدَدْ الرَحْلَات اِلْي جَايهْ
كَام عَدَد الرَّحَلاَت المُغَادره	كَام عَدَدْ الرَّحْلَاتْ الْمَغَادِره
عَايِز أَعرَف مَوَاعِيِد رَحَلاَت المُغَادرَه	عَايِز اَعْرَفْ مَوَاعِيدْ رَحَلَاتْ الْمَغَادِرَه
عَايِز أَعرَف مَعَاد رِحله جَدَه	عَايْز اَعْرَفْ مَعَادْ رَحْلَه جِدْهُ
إِمتَه هَتُوصَل الرِحله رَقَم واحِد اتنِين تَلَاتَه	اَمْتَهْ هَتَوَصَلْ الْرَّحْله رَقَمْ وَاحِد اِتْنِين تَلَاتَه
مَعَاد وِصُول الرِحله رَقَم	مَعَادْ وَصولْ الرَّحَله رَقَمْ
مِعَاد وِصُول الرِحله رَقَم تَلَاتَه اِتنِين وَاحِد	مَعَادْ وَصولْ الرَّحْله رَقْمْ تَلَاتِه اِتْنِين وَاحِد
أَرجُو التَّعدِيل	اَرْجُو الْتَعْدِيلْ
عَدِّل الحَجزَ لَو سَمَحت	عَدْلْ الْحَجْزْ لو سَمَحْتْ
غَيِّر مَوعِدَ الحَجّز إلى	غِيْر مَوَعْدْ الْحَجْزْ اِلْى
هُو إِيه رَقَم الحَجّز	هُو اَيَه رَقَمْ الْحَجْزْ
لَو سَمَحت عِيِد عَلَيَّ المَعلُومَات إللِّي أُلتَهَا	لو سَمْحْتَ عِيْدْ عَلِي الْمَعْلُومَات اللِّي التَهَا
عَايِز أَتكَلِم مَع المَسئُول	عَايِزْ اِتْكَلْم مَعْ الْمَسِيول
عَايز أَتكَلِم مَع وَاحِد تَانِي	عَايِزْ اِتْكَلْم مَعْ وَاحِد تَانِي
عَايز أَسَافِر إِلَى	عَايْزْ اِسَافِرْ اِلَى
عَايِز أَلغِي الحَجز	عَايِزْ اَلغِي الْحَجّزْ
الحَجز مُش مُنَاسِب	الْحَجِّزْ مُشْ مَنَاسِبْ
عَايِز أَدفَع تَمَن التَذكَرَه	عَايِزْ اِدْفَعْ تَمْنْ الْتَّذْكْرْه
كَم مَجمُوع تَمَن التَذَاكِر	كُمْ مَجْمُوعْ تِمَنْ الْتَذَاكِرْ
مَجمُوع التَمَن	مَجْمُوعْ الْتَمْنْ
كَم السِّعر الكُلِّي	كُمْ السَّعْرْ الكُلِي
عَايِز أَدفَع فِلُوس التَذكَرَة دِلِوَئتِي	عَايِزْ ادْفَعْ فِلُوسْ التَّذْكرَة دَلوِيتِي
هَدفَع بِالبِطَائَه الِإئتِمَانِيه	هَدْفَعْ بِالْبَطَايه الْاَيْتْمَانِيه
هُوَّ إِيه رَقَم التَذكَره الإلِكتُرونِيَه	هُو اَيْه رَقَمْ الْتَّذْكرْه الْاِلْكْتْرُونِيهْ
إِيه هِوَّا رَقَم التَذكَرَه الإلِكتُرونِيَه	اَيْهْ هُوَا رَقَمْ الْتَذْكرْه الْاِلْكْتْرُونِيه
اِطبَع كَرتَ الصُّعُودِ لِلطَّائِرَة	اَطْبَعْ كُرْتِ الصَّعودْ لِلْطَايِرَة
عَيزَك تِطَلَع كَرتَ الصُّعُود	عَيْزَكْ تَطْلَع كُرْتْ الصّعودْ
غَيِّرِ المقَاعِدَ لَو سَمَحت	غَيْرْ الْمَقَاعِدْ لَو سَمَحْتْ
عَايِز أَغَيَر المَقَاعِد	عَايِزْ اَغِيرْ الْمَقَاعِدْ
تِئدَر تِأَكِّدِ الحَجز دَه	تِيْدَرْ تَاكِدْ الْحَجْزْ دَهْ
جَمب الشِّبَاك	جَمْبْ الْشِّبَاكْ
عَلَى المَمَر	عَلَى الْمَمَرْ
جَمب مَخرَج الطَوَارِئ	جَمْبْ مَخْرَجْ الطَّوَارِي
حَجز	حَجْزْ
تَذكَرَة	تَذْكَرَة
كَرتُ صُعُود	كرت صَعودْ
رَقم	رَقَمْ
شِّبَاك	شَبَاكْ
الرِّحلَة	الرحْلَة
كَم رَقَم بَوَّابَةِ الدُّخُول	كُمْ رَقْمْ بْوَابَة الدَّخُولْ
عَايِز أَعرَف رَقَم البَوَابَه	عَايِزْ اَعْرَفْ رَقَمْ الْبَوَابِه
رَقم الحَجز لَو سَمَحت	رَقَمْ الْحَجْزْ لَو سَمَحَتْ
عَايِز رَقَم الحَجز	عَايِزْ رَقَمْ الْحَجْزْ
عَايِز أَعرَف رَقَم الحَجز	عَايِزْ اَعْرَف رَقَمْ الْحَجْزْ
عَايِز أَعرَف رَقَم الرِّحلَه	عَايِزْ اَعْرَف رَقَمْ الْرَحْله
عَايِز أَعرَف رَقَم الصَالَه	عَايِزْ اَعْرَفْ رَقَمْ الصَالِه
عَايِز أَأَكِّد الحَجِز	عَايْزْ اَاْكَد الْحَجْزْ
عَايِز أَعرَف وَئت الرِّحلَه	عَايِزْ اَعْرَف وَيْتْ الرَحْله
عَايِز أَعرَف وَئت وصُول الرِّحلَه	عَايِزْ اَعْرَفْ وِيْتْ وَصولْ الرَّحَله
الصُوت مُش وَاضِح	الصوْتْ مِشْ وَاضِح
مُش سَمعَك	مَش سِمْعَكْ
مُش آدِر أَسمَع صُوتَك	مِشْ اَدْرْ اَسْمَعْ صُوتَكْ
صُوتَك وَاطِي	صُوْتِكْ وَاطِي
حَجز جِدِيد لَو سَمَحت	حَجْزْ جْدِيد لو سَمَحْتْ
عَايِز أَعرَف وَئت مُغَادَّرَه الرِحلَه	عَايِزْ اَعْرَف وَيْتْ مَغَادِرْهْ الرَحْله
هِيِا الرِحلَه إِتأَخَرت	هِيَا الرَحْله اَتَاخَرَتْ
هِيَّ الطَيَاره هَتِطلَع فِى مَعَدهَا	هِي الطَّيَارَه هَتْطَلَع فَى مَعْدْهَا
الرِحلَه فِي مَعَدهَا	الرَحْله فِي مَعْدْهَا
الرِحلَه اِتأَخَرِت سَعتِّين	الرَحْله اَتَاخَرْتْ سَعْتِينْ
الصَّالَةُ المَحَلِيَّة	الصَالَة الْمَحْلِيَّة
الصَّالَةُ الدَّاخِلِيَّة	الصَالَة الْدَّاخْلِيَّة
الصَّالَةُ الدَّولِيَّة	الْصَالَة الدُّولِيَة
الصَّالَات الدَّولِيَّة	الصَالَات الدُّولِيَة
صَالَةُ المُغَادَرَة	صَالَة الْمَغَادِرَة
صَالَةُ القُدُوم	صَالَة الْقُدُومْ
صَالَات الخِطُوط الأَجنَبِيَّة	صَالَاتْ الْخَطوط الْاَجْنِبِيَة
الخِطُوط الأَجنَبِيَّة	الْخَطوطْ الْاَجْنِبِيَّة
الأَمتعَه دِي بِتَعتِى	الْاِمْتَعْه دِي بِتَعَتَى
دِي حَاجتِي	دِي حَاجْتِي
سَبَع قِطَع	سَبْعْ قَطَعْ
خَمَس قِطَع	خَمْسْ قَطَّعْ
عَرَبِية أَطفَال	عَرَبِيَة اَطْفَالْ
اَيوَه القِطعَة دِى بِتَعتِى	اَيوْهْ الْقُطْعَة دَى بِتَعَتَى
اَيوه أَنَا بَدَور عَلى القِطعَة دِي	اَيوهْ اَنَا بِدُوْرْ عَلَى الْقُطْعَة دِي
مَكَانُ سَيَّارَاتِ الأُجرَةِ لَو سَمَحت	مَكَان سَيَارَاتْ الْاَجْرَة لو سَمَحْتْ
سّيَّارَاتُ الأُجرَة	سَيَّارَات الْاَجْرَة
سّيَّارَةُ الأُجرَة	سَيَّارَة الْاَجْرَة
فِينِ الطَرِيءِ لِفُندُء الَمَطَار	فِينْ الطَّرِيء لِفَنْدِءْ المَطَار
أَأرَب فُندُء	اارَبْ فِنْدْءْ
صَالَة	صَالَة
صَالَات	صَالَاتْ
رِحلَة	رَحَلَة
حَجَات	حَجَاتْ
كَرتَ الصُّعُود	كَرْت الصَّعودْ
بَدَور عَلى مُجَمَع أَسوَاء	بِدُوْر عَلَى مَجْمَعْ اَسْوَاء
أَنَا بَدَور عَلى	اَنَا بِدوْر عَلَى
عَايِز مُسَعدَه	عَايْزْ مْسْعَدَه
أَنَا عَايِز مُسَّعدِتَك	اَنَا عَايِزْ مِسْعَدْتَكْ
عَايِز تَكسِي	عَايْزْ تَكْسِي
تِئدَر تِسعِفِني	تِيْدَرْ تَسْعِفْنِي
عَايِز سَيَارَة أُجرَه	عَايِزْ سِيَّارَة اَجْرَهْ
عَايِز مَوقِع سَيَارَات أُجرَه	عَايِزْ مَوْقَعْ سَيَارَات اِجْرَه
إِيه أَأرَب مُستَشفَى	اَيْهْ اارَبْ مَسْتَشَفَى
أَنَا بَدَور عَلى شَارِع	اَنَا بِدوْر عَلَى شَارِع
بَدَوَر عَلى أَأرَب مَركَز صِحِي	بِدُوْر عَلَى اارْب مَرْكِز صَحِي
عَايِز عِلِاج	عَايِز عَلَاج
عَايِز الشُرطَة	عَايِزْ الشَّرْطَة
أَنَا عَايِز الشُرطَة	اَنَا عَايِزْ الشَّرْطَة
عَايِز لِّيمُوزِين	عَايِزْ لِيْمُوزِين
أَنَا عَايِز مُسَعدَه	اَنَا عَايِزْ مَسْعَدْهُ
عَايِز تَكسِي	عَايْزْ تَكْسِي
كَم المَسَافَه مِن الرِياض لِمَكَه	كَمْ الْمَسَافِه مِنْ الرِيَاضْ لِمْكَه
تَاكسِي كِبِير لَو سَمِحت	تَاكْسِي كَبِير لو سَمَحْتْ
عَايز مُوَاصلَات	عَايْزْ مُوَاصْلَاتْ
عَايز أَعرَف حَرَكِة السِّير	عَايِزْ اَعْرَف حَرَكَة الْسِيْر
هُو فِيه زَحمَة	هُو فِيهْ زَحْمَة
السِّاعِة كَام	الْسَاعَة كَامْ
كَم سِعرَ صَرف	كمْ سَعْرْ صَرْفْ
العِنوَان إِيه	الْعَنوَانْ اَيْه
العِنوَان إِيه	الْعُنوان اَيهْ
مُمكِن تِدِّينِي العِنوَان	مُمْكِنْ تِدِينِي الْعُنْوَانْ
إِيه أَأرَب طَرِيء لِ	اَيْه اارَب طَرِيءْ ل
مُمكِن أَتَّصِل	مُمْكِنْ اَتْصَلْ
إِزَّاي أَتَّصِل	اَزَاي اَتْصَلْ
إِيه هُوَا مُفتَاح الدَوله	اَيْه هُوَا مَفْتَاحْ الدُّولْهْ
إِيه هِوَّا مُفتَاح المَدِينَه	اَيْهْ هُوَا مِفْتَاحْ الْمَدِينْه
الجَوّ عَامِل إِيه فِي مَكة	الجَوّ عَامِل اِيْه فِي مَكَة
الجَوّ عَامِل إِيه فِي الرِّيَاض	الجَوْ عَامِل اَيْه فِي الرِيَاضْ
الجَوّ عِامِل إِيه فِي	الجَو عَامِل اِيْه في
المَسَافَة كَام لِحَد	الْمَسَافَة كَام لَحَدْ
دَرَجَة الحَرَارَة كَام	دَرَجَة الْحَرارَة كَام
أَأرَبُ صَيدَلِيَّة لَو سَمَحت	ااْرِبْ صَيْدَلِية لُو سَمَحْتْ
الشَمس بِتِطلَع إِمتَه	الشمْسْ بِتْطَلَع امْتَهُ
الشَمس بِتُغرُب إِمتَه	الشَّمْسْ بِتْغْرَب اِمْتَه
الرِّيَال	الرِيَالْ
الدُّولَار	الدُّولَارْ
الجِنِيه	الْجَنِيه
اللَّيرَة	الْلِيرَة
الدِّرهَم	الدَّرْهُمْ
رِيَال	رِيَالْ
دُولَار	دولَار
جِنَيه	جَنِيه
لِيرَه	لِيْرَهْ
دِرهَم	دَرهَمْ
تَاكسِي	تَاكْسِي
شَارِع	شَارِع
طَرِيء	طَرِيء
مَسَافَة	مَسَافَة
عَايِز مَطعَم	عَايْزْ مَطْعَمْ
فِين مُجَمَع المَطَاعِم	فِينْ مَجْمَعْ الْمَطَاعِم
إيه هُو أَأرَب مَطعَم	اَيْه هُو اَاْرِب مَطْعَمْ
عَايِز اَستَعلم عَن بُضَاعَه	عَايِزْ اسْتَعْلِم عَنْ بِضَاعَه
القِطعَه دِي بكَام	الْقَطْعَه دِي بِكَام
دِي بكَام	دِي بِكَام
كَم تَمَن دِي	كمْ تَمْنْ دِي
بكَام دِي	بْكَام دِي
كَم تَمَن دَا	كمْ تَمْنْ دَا
بِكَام القِطعَه دِي	بِكَام الْقَطْعَه دِي
عَايِز أَعرَف تَكَالِيف	عَايِزْ اَعْرَفْ تْكَالِيف
عَايِز أَشُوف الفَتُورَه	عَايِزْ اَشوف الْفَتُوره
عَايِز أَتأَكِد مِن صِحَة البَيَنَات	عَايْزْ اَتَاكِدْ مِنْ صَحَة الْبَيْنَات
عَايِز أَشتَرِي سِلعَه	عَايِزْ اِشْتِرِي سِلْعَه
عَايِز أَعرَف إِنتِهَاء صَلَاحِية السِّلعَه	عَايِزْ اَعْرَفْ اِنْتِهَاءْ صَلَاحِيَة السّلْعَه
عَايِز أَعرَف تَّمَن السِّلعَه دِي	عَايِزْ اَعْرَفْ تَمْنْ السّلْعُهْ دِي
عَايِز أَعرَف مُوَاصَفَات السِلعَه دِي	عَايِزْ اَعْرَفْ مَوَاصَفَاتْ السِّلْعَهْ دِي
الصِوت مُش وَاضِح	الصوْتْ مِشْ وَاضِح
مُش سَمعَك	مَشْ سَمْعَكْ
مُش عَارِف أَسمَع صُوتَك	مشْ عَارِفْ اَسْمَعْ صُوتَكْ
صُوتَك وَاطي	صُوتِكْ وَاطِي
إِيه هِيَّا أَوءَات العَمَل	اَيْه هِيَا اُوءَاتْ الْعَمَلْ
الشُّغل بِيِبدَأ إِمتَه	الشَّغْلْ بِيبْدَا اِمْتَهُ
الشُغل بِيِخلَص إِمتَه	الْشَّغْلْ بِيْخْلِصْ اِمْتَه
المَحَل بِيِفتَح إِمتَه	الْمَحَل بِيْفْتْحْ اِمْتَهُ
المَحَل بِيِئفِل إِمتَه	الْمَحَلْ بِيِيْفِلْ اِمْتَهُ
دَه مُش صَح	دَه مِشْ صَحْ
عَايِز سَيَّارَات الأُجرَة	عَايِزْ سَيَارَاتْ الْاَجْرَة
فِين المَحَل اِللِي بِيِبِيع الأُمَاش	فِينْ الْمَحَل اللي بِيْبِيع الْاَمَاش
فِين مَحَلَّات البِيع بِالجُمَلة	فِينْ مَحَلَاتْ الْبِيعْ بِالْجُمْلَة
عَايِز أَعرِف عِنوَان	عَايِز اَعْرَفْ عَنْوان
فِين مَوقِع الشِّركَة الرَئِيِسِي	فِينْ مُوْقَعْ الشِّرْكَة الْرِييْسِي
هُو فِيه مَرَاكِز خَدَمَات دَاخِل السُوء	هُو فِيهْ مَرَاكِز خَدْمَاتْ دَاخِلْ السُّوءْ
فِين أَأرَب بَنك	فِينْ اارِب بَنَكَ
مَحَلَّاتُ الأَطفَال	مَحَلَاتْ الْاَطْفَال
إِزَّاَي تِّئدَرُوا تسَعدُونِي	اَزَاي تِيْدْرُوا تَسْعُدونِي
عَندِي حَالَة طَوَارِئ	عَنْدِي حَالَة طَوَارِي
إِيه هِيَّا أَوءَات العَمَل	اَيْه هِيَا اَوءَاتْ الْعَمَلْ
بِتِشتَغَلو يَوم الخَمِيس	بِتْشْتَغْلُو يَومْ الْخَمِيسْ
فِين الحَمامَات	فِينْ الْحَمَامَاتْ
فِين الحَمامَات	فِينْ الْحَمَامَاتْ
مُمكِن تِئولِي عَلى مَكَان الحَمامَات	مُمْكِنْ تِيولِي عَلَى مَكَان الْحَمَامَات
هُو فِيه حَمامَات أُرّيِبَه	هُو فِيهْ حَمَامَاتْ اَرِيبْهْ
إِيه أَأرَب حَمامَات	اَيْهْ اَاْرَبْ حَمَامَاتْ
غَالِي	غَالِي
غَالِيَة	غَالِيَة
رِخِيص	رَخِيصْ
رِخِيصَة	رَخِيصَة
غَالِيَة أَوِي	غَالِيَة اَوِيْ
الهِدُوم	الْهَدوم
الحِلاَئَة	الْحْلَايَة
الهِدُوم النِّسَائِيَّة	الْهُدُوم الْنِّسَايِيَة
الهِدُوم الرِجَالية	الْهَدومْ الْرِجَالِيَة
مَحَل	مَحَلْ
مَركز	مَرْكَزْ
خَدَمَات	خَدْمَاتْ
سِعر	سَعْر
السَّبت	السَبْتْ
الحَد	الحَدّ
اللِّتنَين	الْلِتْنِين
التَلَات	الْتَّلَاتْ
الَاربَع	الْاَرْبَع
الخَمِيس	الخَمِيسْ
الجُمعَه	الْجُمْعه
أَيَّام الأُسبُوع	اَيَامْ الْاَسْبُوعْ
نِهَايَةُ الأُسبُوع	نِهَايَة الْاَسْبُوعْ
أجَازَة الاسبُوع	اَجَازَة الْاَسْبُوعْ
الخَمِيس وَ الجُمعَه	الخَمِيسْ وْ الْجَمْعه
النَهَاردَه	الْنّهَارْدْهْ
اِمبَارِح	امْبَارِحْ
بَعد إِبرِيل	بَعَدْ اَبْرِيلْ
بَعد أَغُسطُس	بَعَدْ اَغْسَطِسْ
بَعد أَكتُوبَر	بَعَدْ اَكْتُوبْرْ
بَعد إِسبُوع	بَعَدْ اَسْبُوعْ
بَعد الأَجَازِه	بَعَدْ الْاَجَازِه
بَعد التَلَات	بَعَدْ التَّلَاتْ
بَعد الخَّرِيف	بَعَدْ الخَرِيفْ
بَعد الدِّرَاسّة	بَعَدْ الْدِّرَاسَة
بَعد الرَبِيع	بَعَدْ الرَّبِيعْ
بَعد السَبِت	بَعَدْ السَّبْتْ
بَعد الشَبط	بَعَدْ الشَّبْطْ
بَعد الشِّتَا	بَعَدْ الْشَّتَا
بَعد العَصر	بَعَدْ الْعَصْرْ
بَعد العَقَارِب	بَعَدْ الْعَقَارِب
بَعد العِيد	بَعَدْ الْعِيْد
بَعد المِربّعَانِيَّه	بَعَدْ الْمَرَبِعَانِيهْ
بَعد المَغرِب	بَعَدْ الْمَغْرِب
بَعد أَسبُوع	بَعَدْ اَسْبُوعْ
بَعد أَغُسطّس	بَعَدْ اَغْسَطَسْ
بَعد اكتُوبَر	بَعَدْ اَكْتُوبْرْ
بَعد أَيلَول	بَعَدْ اَيْلُولْ
بَعد إِبِرِيل	بَعَدْ اِبْرِيلْ
بَعد أَجَازِة نِهَايِة الَأسِبوع	بَعَدْ اَجَازَة نِهَايَة الْاَسْبُوعْ
بَعد جَمَادِي الَاوَل	بَعَدْ جَمَادِي الْاَوَلْ
بَعد جَمَادِي الَاخِر	بَعَدْ جَمَادِي الْاَخْر
بَعد جَمَادِي التَانِي	بَعَدْ جَمَادِي التَانِي
بَعد دِئِيئَه	بَعَدْ دِيييهْ
بَعد دِيسَمبِر	بَعَدْ دِيْسَمْبَرْ
بَعد زِي الحِجَّه	بَعَدْ زِيْ الْحَجّه
بَعد زِي القِعدَه	بَعَدْ زِيْ الْقَعْدَه
بَعد رَبِيع الَاِخِر	بَعَدْ رَبِيعْ الْاَخْر
بَعد رَبِيع الَأَوَل	بَعَدْ رَبِيعْ الْاَوَلْ
فِي الخَرِيف	فِي الخَرِيفْ
فِي الَخمِيس	فِي الْخَمِيسْ
فِي الدِّرَاسَة	فِي الْدِّرَاسَة
فِي الرَّبِيع	فِي الرَّبِيعْ
فِي السَّبت	فِي الْسَبْتْ
فِي الشِّبط	فِي الشَبْطْ
فِي الشِّتَا	فِي الشَتَا
فِي الشّهر الجَاي	فِي الشَهْرْ الجَاي
فِي الصُبح	فِي الصَّبْح
فِي الصَّيف	فِي الصَيْفْ
فِي الضُّهر	فِي الضَهْر
فِي السَنَه دِي	فِي السَّنْهْ دِي
فِي السَنَه الدِّرَاسِيِه	فِي الْسِنْه الْدِّرَاسِيهْ
فِي السَنَه ال جَايه	فِي السَّنْه ال جَايَهْ
فِي السَنَة المِيلَادِية	فِي الْسَّنَة الْمِيلَادِيَة
فِي السَنَّة الهِجرِيَة	فِي الْسِّنَة الْهَجْرِيَة
فِي العَصر	فِي الْعَصْرْ
فِي العِيد	فِي الْعِيْد
فِي اللّيل	فِي الْلِيْلْ
فِي المِربِعَانِيَّه	فِي الْمَرَبْعَانِيهْ
فِي اللّيل	فِي الْلِيْلْ
فِي المَغرِب	فِي الْمَغْرِبْ
فِي النّهَار	فِي الْنّهَارْ
فِي الوَسم	فِي الوَسْمْ
فِي أَغُسطَس	في اغْسَطَس
فِي أَكتُوبَر	فِي اَكْتُوبَرْ
فِي أَجَازَة آخِر الَأسبُوع	فِي اَجَازَة اَخْرِ الْاِسْبُوعْ
فِي ثَانِيَة	فِي ثَانِيَة
فِي جَمَادِي الَأوَل	فِي جَمَادِي الْاَوَلْ
فِي جَمَادِي الَآخِر	فِي جَمَادِي الْاَخْر
فِي جَمَادِي التَانِيَة	فِي جَمَادِي الْتَانِيَة
فِي دِيسَمبِر	فِي دِيسُمْبَرْ
فِي زِي الحِجَّة	فِي زِيْ الْحَجَّة
فِي زِي القِعدَة	فِي زِيْ الْقَعَدَة
فِي رَبِيع الَآخِر	فِي رَبِيعْ الْاَخْر
فِي رَبِيع الَأَوَل	فِي رَبِيعْ الْاَوَلْ
فِي رَبِيع التَانِي	فِي رَبِيعْ الْتَّانِي
فِي رَجَب	فِي رَجَبْ
فِي شَهر	فِي شَهْرْ
فِي سَاعَة	فِي سَاعَة
فِي سِبتَمبِر	فِي سِبْتَمْبَرْ
فِي سَنَة	فِي سَنَّة
فِي سُهَيل	فِي سَهيل
فِي شُبَاط	فِي شَبَاطْ
فِي شَعبَان	فِي شَعْبَانْ
أَبلَ الَأجَازَة	اَبَلْ الْاَجَازَة
أَبلَ التَلَات	اَبَّلْ التَّلَاتْ
أَبلَ الخَرِيف	اَبْلْ الخَرِيفْ
أَبلَ الخَمِيس	اَبَلْ الخَمِيسْ
أَبلَ الدِّرَاسَة	اَبَّلْ الْدِّرَاسَة
أَبلَ الرَّبِيع	اَبَلْ الربِيعْ
أَبلَ السَّبت	اَبَلْ السَّبْتْ
أَبلَ الشَّبط	اَبَلْ الشَّبْطْ
أَبلَ الشِّتَا	اَبْلْ الْشَتَا
أَبلَ الشّهر ال جَاي	اَبَّلْ الشَّهْرْ ال جَاي
أَبلَ الصُبح	اَبَلْ الصَّبْحْ
أَبلَ الصِيف	اَبَلْ الصَيْفْ
أَبلَ الضُهّر	اَبَلْ الضَهْر
أَبلَ السَنَة الدِّرَاسِية	اَبَلْ الْسِّنَة الْدَّرَاسِيَة
أَبلَ السَنَة الِّجَيَة	اَبَلْ السِّنَة الْجَيَّة
أَبلَ السَنَة المِيِلَادِية	اَبَّلْ السِّنَة الْمِيلَادِيَة
أَبلَ السَنَة الهِجرِية	اَبَّلْ الْسِّنَة الْهَجْرِيَة
أَبلَ العَصّر	اَبْلْ الْعَصْرْ
أَبلَ العِيد	اَبَلْ الْعِيْد
أَبلَ الِليِل	اَبَّلْ الْلِيْلْ
أَبلَ المِربعَانِّية	اَبَلْ الْمَرَبَّعَانِيَّة
أَبلَ اللِيل	اَبَلْ الْلِيْلْ
أَبلَ المَغرِب	اَبَلْ الْمَغْرِب
أَبلَ النِهَار	اَبَلْ النَّهَارْ
أَبلَ الوَسِم	اَبْلْ الْوَسِمْ
أَبلَ أَسبُوع	اَبَّلْ اِسْبُوعْ
أَبلَ أَغُسطُس	اَبَّلْ اَغْسَطِسْ
أَبلَ أَكتُوبَر	اَبَّلْ اَكْتُوبَرْ
أَبلَ امّبَارِح	اَبْلْ امْبَارَح
أَبلَ إِبرِيل	اَبَّلْ اِبْرِيلْ
أَبلَ أَجَازَة الجُمعَه	اَبَلْ اَجَازَة الْجُمْعه
مِن ثَانِيَة	مِنْ ثَانِيَة
أَبلَ جَمَاد الَأوَل	اَبَلْ جَمَاد الاَوَّل
أَبلَ جَمَادِ الَآخِر	اَبَلْ جَمَادْ الْاَخَر
أَبلَ جَمَادِ التَانِي	اَبَلْ جَمَاد التَّانِي
مِن دِئِيئَه	مِنْ دِيييهْ
أَبلَ دِيّسَمبِر	اَبَّلْ دِيسُمْبَرْ
أَبلَ زِي الحِجَة	اَبَلْ زِيْ الْحَجَّة
أَبلَ زِي القِعدَه	اَبْلْ زِيْ الْقَعْدَه
أَبلَ رَبِيع الَأوَل	اَبَلْ رَبِيعْ الْاَوَل
أَبلَ رَبِيع الَآخِر	اَبَلْ رَبِيعْ الْاَخْر
أَبلَ رَجَب	اَبَلْ رَجْبْ
أَبلَ سَاعة	اَبَّلْ سَاعَةْ
أَبلَ سِبتَمبِر	اَبَّلْ سِبْتَمْبَرْ
أَبلَ سَنَة	اَبْلْ سَنَة
بَعد رَبِيع التَانِي	بَعَدْ رَبِيعْ الْتَّانِي
بَعد رَجَب	بَعَدْ رَجْبْ
بَعد رَمَضَان	بَعَدْ رَمْضَانْ
بَعد سَاعَة	بَعَدْ سَاعَةَ
بَعد سِبتَمبِر	بَعَدْ سِبْتَمْبَرْ
بَعد سَنَه	بَعَدْ سَنْهُ
بَعد سُهَيل	بَعَدْ سَهيلْ
بَعد شُبَاط	بَعَدْ شَبَاطْ
بَعد شَعبَان	بَعَدْ شَعْبَانْ
بَعد شَهَر	بَعَدْ شَهْرْ
بَعد صَفَر	بَعَدْ صَفْرْ
بَعد سَنَه	بَعَدْ سَنْهُ
بَعد عَقد	بَعدْ عَقَدْ
بَعد عِيد الحَج	بَعَدْ عَيْدْ الحَجّ
بَعد عِيد الفِطر	بَعَدْ عِيْدْ الْفَطْرْ
بَعد بُكرَه	بَعَدْ بِكْرَهْ
بَعد مَارِس	بَعَدْ مَارِسْ
بَعد مَايُو	بَعَدْ مَايُو
بَعد مُحَرَم	بَعَدْ مَحْرَمْ
بَعد نُوفَمّبِر	بَعَدْ نُوفَمْبِرْ
بُكّرَه	بِكْرَه
فِي اكتُوبَر	فِي اَكْتُوبَرْ
فِي الأسبُوعِ الجَاي	فِي الْاَسْبُوعْ الجَاي
فِي الأَجَازَة	فِي الْاَجَازَة
فِي شَهَر	فِي شَهَرْ
فِي صَفَر	فِي صَفْرْ
فِي سَنَة أَلف وَاربَعمِيِّة وتَلَاتَ وتَلاتِين هِجرِي	فِي سِنَة اَلْف وَارْبَعْمِيَّة وَتَلَاتْ وَتْلَاتِينْ هَجْرِي
فِي سَنَة أَلفين وَاتنَاعَشَر مِيلَادِي	فِي سِنَة الْفِينْ وَاتْنَاعَشْر مِيلَادِي
فِي عِيد الحَج	فِي عِيْدْ الحَجّ
فِي عِيد الفِطر	فِي عِيْدْ الْفَطْرْ
فِي فِبرَايِر	فِي فِبْرَايِرْ
فِي كَانُون الَأوَّل	فِي كَانُون الْاَوَّلْ
فِي كَانُون التَانِي	فِي كَانُون الْتَانِي
فِي مَارِس	فِي مَارِس
فِي مَايُو	فِي مَايو
فِي مُحَرَّم	فِي مَحْرَمْ
فِي نُوفَمبِر	فِي نُوفَمْبَرْ
فِي نِيسَان	فِي نِيسَانْ
فِي الأَسبُوع دَه	فِي الْاِسْبُوعْ دَهْ
فِي الشّهر دَه	فِي الْشَّهْر دَهْ
فِي يُولِيُه	فِي يُولِيهْ
فِي يَوم	فِي يَومْ
فِي يُونِيَه	فِي يُونِيهْ
أَبلَ أَكتُوبَر	اَبَّلْ اَكْتُوبَرْ
أَبلَ الحَد	اَبَلْ الحَدْ
أَبلَ الأَربَع	اَبْلْ الْاَرْبَعْ
أَبلَ الأَسبُوع الجَاي	اَبْلْ الْاَسْبُوعْ الْجَاي
أَبلَ اللِّتنِين	اَبْلْ اللُّتْنِين
أَبلَ سُهَيل	اَبَّلْ سَهيلْ
أَبلَ شِبَاط	اَبَلْ شْبَاطْ
أَبلَ شَعبَان	اَبَّلْ شَعْبَانْ
أَبلَ شَهر	اَبَلْ شَهْرْ
أَبلَ شَوَّال	اَبَلْ شُوَال
أَبلَ صَفَر	اَبَّلْ صَفْرْ
أَبلَ سَنَة	اَبَلْ سَنة
أَبلَ سَنَة أَلف وَاربَعمِيِّة وتَلَاتَ وتَلاتِين هِجرِي	اَبَلْ سِنَّة اَلْف وَارْبَعْمِيَّة وَتْلَاتْ وَتَلَاتِين هَجْرِي
أَبلَ سَنَة أَلفين وَاتنَاعَشَر مِيِلَادِي	اَبَلْ سِنَة الْفِينْ وَاتْنَاعَشْرْ مِيْلَادِي
أَبلَ الحِج	اَبَلْ الحَجّ
أَبلَ عِيد الفِطر	اَبَلْ عَيْدْ الْفَطْرْ
أَبلَ فِبرَايِر	اَبَّلْ فِبْرَايِر
أَبلَ مَارِس	اَبَّلْ مَارِسْ
أَبلَ مَايُو	اَبْلْ مَايُو
أَبلَ مًحَرَم	اَبَلْ مَحْرَمْ
أَبلَ الَأسِبُوع دَه	اَبَّلْ الْاَسْبُوعْ دَهْ
أَبلَ الشّهر دَه	اَبَلْ الشَّهْرْ دَهْ
أَبلَ يُولِيُه	اَبْلْ يولِيهْ
أَبلَ يِوم	اَبَلْ يومْ
أَبلَ يُونّيُه	اَبَلْ يُونِيهْ
الَأسبُوع دَه	الْاَسْبُوعْ دَهْ
الشَهر دَه	الشَّهْرْ دَه
السَنَا دِي	الْسَّنَا دِي
الوَئت دَه	الويتْ دَهْ
الرِّيَال	الرِيَال
الدُّولَار	الدُّولَارْ
الجِنِيه	الْجَنِيه
اللِّيرَه	الْلِيرَهْ
الدَّرَاهِم	الْدَّرَاهُمْ
رِيَال	رِيَالْ
دُولَار	دولَارْ
جِنِيه	جَنِيهْ
لِيرَه	لِيْرَهْ
دِرهَم	دَرهُم
رِيَالَات	رِيالَات
دُولَارَات	دولَارَاتْ
جُنَيهَات	جَنِيهَاتْ
لِيرَات	لِيْرَاتْ
دَرَاهِم	درَاهُم
رِيَال	رِيَال
دُولَار	دولَار
جِنِيه	جَنِيهْ
لِيرَة	لِيرَة
دِرهَم	درهُمْ
رِيَال	رِيَال
دُولَار	دولَار
جِنِيه	جَنِيهْ
لِيرَه	لِيْرَهْ
دِرهَم	درهُم
هَلَلَه	هَلْلَهْ
فِلس	فَلْسْ
بِنس	بِنسْ
سِنت	سَنْتِ
رِيَال	رِيَال
رِيَال	رِيَالْ
رِيَال	رِيَال
رِيَالَات	رِيالَاتْ
رِيَالِين	رِيَالِين
رِيَالِين	رِيَالِيْن
هَلَلَات	هَلْلَاتْ
هَلَلَة	هَلَلَة
هَلَلَة	هَلَلَة
هَلَلَة	هَلَلَة
هَلَلَتَين	هَلْلَتِينْ
هَلَلَتَين	هَلْلَتِينْ
سِنت	سَنْتِ
أَبُوظَبِي	اَبوظْبِي
أَتلَانتَا	اَتْلَانْتَا
أَثِينَا	اَثِينَا
أَحمَد أَبَاد	اَحْمَدْ اَبَاد
إِدَنبَرَه	اَدْنْبَرَه
أَدِيس أَبَابَا	اَدِيس اَبَابَا
أَزمِير	اِزْمِير
إِسبرِنق فِيلد	اَسْبَرْنِقْ فِيلْدْ
أُستُكهُولم	اَسْتَكْهُولْم
إِسطَنبُول	اَسْطَنْبُولْ
إِسلام أَبَاد	اَسْلَام اَبَادْ
أَسوَان	اَسْوَانْ
أَكرَا	اَكْرَا
الإسكَندَريَّة	الْاَسْكِنْدِرِيَّة
أَلبَانِيَا	الْبَانِيَا
البَصرَة	الْبَصْرَة
الجَزَائِر	الْجَزَايِرْ
الخَرطوم	الْخَرْطوم
الدَّارُ البَيضَاء	الدَارْ الْبِيْضَاء
الدِوحَة	الدُّوْحَة
الرِّبَاط	الرَّبَاطْ
القَاهِرَة	القَاهْرَة
القُدس	القُدْس
الكِوَيت	الْكُويْت
المَنَامَة	الْمُنَامَة
المَوصِل	الْمُوْصِل
أُمُّ دَرمَان	امْ دَرْمَان
أَمِستَردَام	اَمْسَتْرْدَام
أنتاناناريفو	اِنْتَانَانَارِيفُو
إِندِيَانَا بُولِس	اِنْدِيَانَا بُولِسْ
أَنقَرَة	انْقَرَة
أُوتَاوَا	اوْتَاوَا
أُورلاندُو	اورْلَانْدُو
أُوستِن	اوسْتَن
أُوسلُو	اوسْلُو
أُوكلاهُومَا	اوْكْلَاهُومَا
بَاتُون رُوج	بَاتُونْ رُوجْ
بَارِيس	بَارِيسْ
بَانجلُور	بانْجلور
بَاندُونج	بَانْدُونِج
بَانكُوك	بَانْكُوكْ
بَرَازِيلِيَا	بْرَازِيلِيَا
بَرشَلُونَة	بَرَشْلُونَة
بِرلِين	بَرْلِينْ
بِرمِنجهَام	بِرْمَنْجِهَامْ
بُوسطُن	بوسْطِن
بُومبَاي	بومْبَاي
بُون	بُونْ
بِيتسُورنِي	بِيْتْسُورْنِي
بِيرث	بِيرَث
بَيرُوت	بِيْرُوتْ
بِيشَاوَر	بِيشَاوِر
بِيغَان	بِيغَان
بِينَانج	بِينَانَج
بِيُونِس اَيرِس	بِيونِسْ ايرس
تَالاهَاسِي	تَالْاَهَاسِي
تَايبِيه	تَايْبِيهْ
تُوبِيكا	توبِيكَا
تُورُنتُو	تُورْنْتُو
تُونِس	تُونِسْ
جَاكَرتَا	جَاكْرْتَا
جلاسكُو	جَلاسْكُو
جُوهَانسبِرج	جوهَانْسِبْرَجْ
جِيبُوتِي	جِيبُوتِي
حَلَب	حَلَبْ
دَارُ السَّلام	دَارْ السَّلَام
دَاروِين	دَارويْن
دَاكَار	دَاكَارْ
دَالَاس	دَالَاسْ
دَبلِن	دِبْلْنْ
دُبَي	دِبِي
دَكَّا	دَكَا
دِمَشق	دِمَشَقْ
دِي تَروِيت	دِي تَرويْتْ
دِيرهَام	دِيرْهَامْ
دِينِفَر	دِينْفْرْ
رُومَا	رُومَا
رِيكَامُوند	رِيكَامُونْدْ
رِيُو دِي جَانِيرُو	رِيو دِي جَانِيْرُو
زِيُورِخ	زِيورَخ
سَان سِلفَادُور	سَانْ سِلْفَادور
سَانتِيَاغُو	سَانْتِيَاغُو
سَاند يِيِجُو	سَانْدْ يِيجُو
سَاو بَاولُو	ساو باولو
سَرَابَايَا	سْرَابَايَا
سَنغَافُورَة	سِنْغَافُورَة
سَيؤُول	سَيِوولْ
سِيدنِي	سِيْدْنِي
شَنغَهَاي	شَنْغْهَايْ
شُونجُونج	شونْجُونَج
فِيَنَّا	فِينَا
كَابُول	كَابُول
كَاردِيف	كارْدِيفْ
كَازَبلَانكَا	كَازْبْلَانْكَا
كَانبِيرا	كَانْبِيرَا
كَرَاتشِي	كَرَاتْشِي
كَرَاكَاس	كَرَاكَاس
كوَالَالَمبُور	كُوالْاَلْمْبُورْ
كوَانتَان	كوانْتَان
كُوبِنهَاجِن	كوبْنْهَاجِنْ
كُولُمبُس	كولْمْبْسْ
كُولُومبُو	كُولومْبُو
كُولُومبِيَا	كولومْبِيَا
كِيب تَاون	كِيبْ تَاونْ
كِيتُو	كِيْتُو
لاس فِيجَاس	لَاس فِيجَاسْ
لاغُوس	لَاغوسْ
لانسِنق	لَانْسِنْقْ
لاهُور	لاهُورْ
لَشبُونَة	لَشْبُونَة
لَندَن	لَنْدِنْ
لُوس أَنجلُوس	لُوسْ انْجَلُوسْ
لِيمَا	لِيمَا
ليُون	لِيُونْ
مَاربِيَّا	مَارِبْيَا
مَارسِيلِيَا	مَارْسِيلِيَا
مَانَاجوا	مَانَاجُوا
مَانِيلا	مَانِيلَا
مِدرَاس	مِدْرَاسْ
مَدرِيد	مَدْرِيد
مَرَّاكِش	مَرَاكِشْ
مَسقَط	مَسْقَطْ
مَقدِيشُو	مَقْدِيشُو
مِكسِيكُو سِتِي	مَكْسِيكُو سْتِي
مَلبُورن	مَلْبُورِنْ
مُوسكُو	مُوْسْكُو
مُونتِريَال	مُونْتْرِيَال
مِيلان	مِيلَانْ
ميُونِخ	مِيونخْ
نَابُولي	نَابولِي
نَانت	نَانَتْ
نَوَاكشُوط	نواكْشُوطْ
نَيرُوبِي	نِيرُوبِي
نِيس	نِيسْ
نيُودِلهِي	نِيودِلْهِي
بِرمِنجهَام	بِرَمَنْجِهَام
برِيتُورِي	بَرِيتُورِي
بَغدَاد	بَغْدَادْ
بِكِّين	بَكِيْن
بِلغرَاد	بِلْغَرَادْ
بَلفَاست	بِلفَاسِتْ
بلُومِنقتُون	بِلُومِنْقْتُونْ
بِنغَازِي	بِنْغَازِي
بُوجُوتَا	بِوجُوتَا
بُوخَارِست	بوخَارْسْتْ
بُودَابِست	بودَابْسْتْ
بُورتلاند	بورْتْلَانِد
بُور سُودَان	بورْ سُودَان
شِيكَاغُو	شِيكَاغُو
صَنعَاء	صَنْعَاءْ
صُوفِيَا	صُوفِيَا
طَرَابلُس	طَرَابْلِسْ
طَهرَان	طَهَرَانْ
طُوكيُو	طُوكِيو
عَبدَان	عَبْدَانْ
عَدَن	عَدَنْ
عَمَّان	عَمَان
غَزَّه	غَزْه
فَانكُوفَر	فَانْكُوفِرْ
فرَانكفُورت	فرَانْكفورتْ
نيُوكَاسِل	نِيوكَاسِل
نيُويُورك	نِيويورَكْ
هَاتفُورد	هَاتْفُورِدْ
هَارسبِيرق	هَارْسْبِيرَقْ
هَافَانَا برَاغ	هَافَانَا بْرَاغْ
هَانُوي	هَانُوي
هِلسِنكِي	هَلْسِنْكِي
هُونج كُونج	هونَجْ كونْجْ
وَارسُو	وَارْسُو
وَاشُنطُن دِي سِي	وَاشْنْطُنْ دِي سِيْ
وُلِينجتُون	وَلِيْنْجْتُونْ
وَهرَان	وَهَرَانْ
وَاحِد	وَاحِد
اِتنِين	اِتْنِيْن
اِتنِين	اِتْنِين
تَلَاتَة	تَلَاتَة
أَربَعَة	اَرْبَعَة
خَمسَة	خَمْسَة
سِتَّة	ستة
سَبعَة	سَبْعَة
تَمَانيَة	تَمَانِيَة
تِسعَة	تَسْعَة
عَشَرَة	عَشَرَة
حِّدَاشر	حَدَاشِرْ
اِتنَاشَّر	اِتْنَاشِر
تَالَتَاشَر	تَالْتَاشِر
أَربَعتَاشَر	اَرْبْعْتَاشِر
خَمَستَاشَر	خَمْسَتَاشِر
سِتَاشَر	سْتَاشِر
سَبَعتَاشَر	سَبْعَتَاشِر
تَمَنتَاشَر	تَمْنْتَاشِر
تِسعتَاشَر	تَسْعَتَاشِر
عِشرِين	عَشْرِينْ
وَاحِد وَعِشرِين	وَاحِد وَعِشْرِينْ
اِتنِين وِعِشرِين	اِتْنِيْن وَعِشْرِيْن
تَلَاته وِعِشرِين	تَلْاتِه وَعِشْرِينْ
أَربَعَة وِعِشرِين	اَرْبَعَة وَعِشْرِينْ
خَمسَة وِعِشرِين	خَمْسَة وَعِشْرِينْ
سِتة وِعِشرِين	سِتَة وَعِشْرِينْ
سَبعَة وِعِشرِين	سَبْعَة وَعِشْرِينْ
تَمَانية وِ عِشرِين	تْمَانِيَة وْ عِشْرِينْ
تِسعَة وِعِشرِين	تِسْعَةْ وَعِشْرِين
تَلَتِين	تَلْتِين
وَاحِد وِتَلَتِين	وَاحْد وَتَلْتِينْ
اِتنِين وِتَلَتِين	اِتْنِين وَتَلْتِيْن
تَلَاتَة وِتَلَتِين	تِلْاَتَة وَتَلْتِين
أَربَعَة وِتَلَتِين	اَرْبَعَة وَتَلْتِينْ
خَمسَة وِتَلَتِين	خَمْسَة وَتَلْتِينْ
سِتَّة وِتَلَتِين	سِتَّة وَتَلْتِينْ
سَبعَة وِتَلَتِين	سَبْعَة وَتَلْتِين
تَمَانيَة وِتَلَتِين	تَمَانِيَة وَتَلْتِيْن
تِسعَة وِتَلَتِين	تِسْعَة وَتَلْتِينْ
أربِعين	اَرْبَعِينْ
وَاحِد وِأربِعين	وَاحْد وَاَرْبَعِينْ
اِتنِين وِأربِعين	اِتْنِين وَاَرْبْعِينْ
تَلَاتَة وِأربِعين	تَلَاتَة وَاَرْبَعِينْ
أَربَعَة وِأربِعين	اَرْبَعَة وَاَرْبَعِينْ
خَمسَة وِأربِعين	خَمْسَة وَارْبْعِينْ
سِتَّة وِأربِعين	سِتَّة وَارْبْعِينْ
سَبعَة وِأربِعين	سَبْعَة وَارْبَعِينْ
تَمَانيَة وِأربِعين	تَمَانِيَة وَاَرْبْعِينْ
تِسعَة وِأربِعين	تِسْعَة وَاَرْبَعِينْ
خَمسِين	خَمْسِينْ
وَاحِد وِخَمسِين	وَاحِد وَخَمْسِينْ
اِتنِين وِخَمسِين	اِتْنِينْ وَخَمْسِيْنْ
تَلَاتَة وِخَمسِين	تَلَاتَة وَخَمْسِيْنْ
أَربَعَة وِخَمسِين	اَرْبَعَة وَخَمْسِينْ
خَمسَة وِخَمسِين	خَمَسَة وَخَمْسِينْ
سِتَّة وِخَمسِين	سَتَة وَخَمْسِينْ
سَبعَة وِخَمسِين	سَبَعَة وَخَمْسِينْ
تَمَانيَة وِخَمسِين	تَمَانِيَة وَخَمْسِيْنْ
تِسعَة وِخَمسِين	تِسْعَة وَخَمْسِينْ
سِتِّين	سَتِين
وَاحِد وِسِتِين	وَاحِد وَسْتِينْ
اِتنِين وِسِتِين	اِتْنِينْ وَسْتِينْ
تَلَاتَة وِسِتِين	تَلْاتَة وَسْتِينْ
أَربَعَة وِسِتِين	اَرْبَعَة وَسْتِينْ
خَمسَة وِسِتِين	خَمْسَة وَسْتِينْ
سِتَّة وِسِتِين	سَتَة وَسْتِين
سَبعَة وِسِتِين	سَبْعَة وَسْتِينْ
تَمَانيَة وِسِتِين	تَمَانِيَة وَسْتِينْ
تِسعَة وِسِتِين	تِسْعَة وَسْتِينْ
سَبعِين	سَبْعِينْ
وَاحِد وِسَبعِين	وَاحِد وَسَبْعِينْ
اِتنِين وِسَبعِين	اِتْنِيْن وَسَبْعِيْنْ
تَلَاتَة وِسَبعِين	تَلَاتَة وَسَبْعِينْ
أَربَعَة وِسَبعِين	اَرْبَعَة وَسَبْعِينْ
خَمسَة وِسَبعِين	خَمْسَة وَسَبْعِينْ
سِتَّة وِسَبعِين	سَتَة وَسَبْعِين
سَبعَة وِسَبعِين	سَبْعَة وَسْبْعِينْ
تَمَانيَة وِسَبعِين	تَمَانِيَة وَسَبْعِيْنْ
تِسعَة وِسَبعِين	تِسْعَة وَسَبْعِينْ
تَمَنين	تَمْنِين
وَاحِد وِتَمَنين	وَاحْد وَتَمْنِين
اِتنِين وِتَمَنين	اَتْنِينْ وَتَمْنِيْنْ
تَلَاتَة وِتَمَنين	تَلْاتَة وَتَمْنِين
أَربَعَة وِتَمَنين	اَرْبَعَة وَتَمْنِين
خَمسَة وِتَمَنين	خَمْسَة وَتَمْنِينْ
سِتَّة وِتَمَنين	سَتَّة وْتَمْنِين
سَبعَة وِتَمَنين	سَبَعَة وَتَمْنِين
تَمَانيَة وِتَمَنين	تَمَانِيَة وَتَمْنِين
تِسعَة وِتَمَنين	تِسْعَة وَتَمْنِين
تِسعِين	تَسْعِينْ
وَاحِد وِتِسعِين	وَاحِد وَتَسَعِينْ
اِتنِين وِتِسعِين	اَتْنِين وَتَسْعِيْنْ
تَلَاتَة وِتِسعِين	تَلَاتَة وَتَسْعِيْنْ
أَربَعَة وِتِسعِين	اَرْبَعَة وَتْسْعِينْ
خَمسَة وِتِسعِين	خَمْسَة وَتَسَعِينْ
سِتَّة وِتِسعِين	سَتَة وَتَسْعِينْ
سَبعَة وِتِسعِين	سَبْعَة وَتْسْعِينْ
تَمَانيَة وِتِسعِين	تَمَانِيَة وَتَسْعِينْ
تِسعَة وِتِسعِين	تِسْعَة وَتْسْعِينْ
مِية	مِيَة
ألف	اِلف
اِثنَا عَشَرَ	اِثْنَا عَشَرْ
اِثنَانِ	اَثْنَانْ
اِثنَتَا عَشرَة	اِثْنَتا عَشْرَة
اِثنَتَانِ	اِثْنَتَانْ
اِثنَتَي عَشرَة	اِثْنِتِي عَشْرَة
اِثنَتَينِ	اَثْنَتِين
اِثنَي عَشَرَ	اِثْنِي عَشَرَ
اِثنَينِ	اثْنِينْ
آلَافٍ	الَافْ
آلَافِ	الَافْ
أَحَدَ عَشَرَ	اَحَدْ عَشَرْ
أَربَعٌ	اَرْبَعْ
أَربَعُ	اَرْبَعْ
أَربَعَ	اَرْبَعْ
أَربَعٍ	اَرْبَعَ
أَربَعِ	اَرْبَعَ
أَربَعَ عَشرَة	اَرْبَعْ عَشْرَة
أَربَعًا	اَرْبَعَا
أَربَعَةٌ	اَرْبَعَة
أَربَعَةُ	اَرْبَعَة
أَربَعَةً	اَرْبَعَة
أَربَعَةَ	اَرْبَعَة
أَربَعَةٍ	اَرْبَعَة
أَربَعَةِ	اَرْبَعَة
أَربَعَة عَشَرَ	اَرْبَعَة عَشْرْ
أَربعُمِائةٍ	اَرْبَعْمَايَة
أَربَعُمِائةِ	اَرْبْعْمَايَة
أَربَعَمِائةٍ	اَرْبْعْمَايَة
أَربَعَمِائةِ	اَرْبَعْمَايَة
أَربَعِمِائةٍ	اَرْبَعْمَايَة
أَربَعِمِائةِ	اَرْبَعْمَايَة
أَربَعُونَ	اَرْبْعُونْ
أَلفٌ	الفَ
أَلفُ	الفْ
أَلفَ	اِلْفَ
أَلفٍ	الْف
أَلفِ	الْفْ
أَلفًا	الفا
أَلفا	الفا
أَلفَانِ	الْفَانْ
أَلفَي	اَلْفِي
أَلفَينِ	اَلْفِينْ
إِحدَى عَشرَة	اَحْدَى عَشْرَة
تِسعٌ	تَسْعَ
تِسعُ	تَسْعْ
تِسعَ	تَسْعْ
تِسع	تَسْعْ
تِسع	تَسْعْ
تِسعَ عَشرَة	تِسْعْ عَشْرَة
تِسعًا	تِسْعَا
تِسعَةٌ	تِسْعَة
تِسعَةُ	تَسْعَة
تِسعَةً	تَسْعَة
تِسعَةَ	تَسْعَة
تِسعَةٍ	تِسْعَة
تِسعَةِ	تَسْعَة
تِسعَةَ عَشَرَ	تِسْعَةْ عَشْر
تِسعُمِائةٍ	تَسْعَمَايَة
تِسعُمِائةِ	تَسْعَمَايَة
تِسعَمِائةٍ	تَسْعْمَايَة
تِسعَمِائةِ	تَسْعْمَايَة
تِسعِمِائةٍ	تَسْعَمَايَة
تِسعِمِائةِ	تَسْعَمَايَة
تِسعُونَ	تَسْعُونْ
تِسعِينَ	تَسْعِينْ
ثَلاثٌ	ثَلَاثْ
ثَلاثُ	ثَلَاثْ
ثَلاثَ	ثَلَاثْ
ثَلاثٍ	ثَلَاثْ
ثَلاثِ	ثَلَاثْ
ثَلاثَ عَشرَة	ثَلَاثْ عَشْرَة
ثَلاثًا	ثَلَاثَا
ثَلاثَةٌ	ثَلَاثَة
ثَلاثَةُ	ثَلاثَة
ثَلاثَةً	ثَلْاثَة
ثَلاثَةَ	ثَلْاثَة
ثَلاثَةٍ	ثَلَاثَة
ثَلاثَةِ	ثَلَاثَة
ثَلاثَةَ عَشَرَ	ثَلَاثَة عَشَرْ
ثَلَاثُمِائةٍ	ثَلْاثْمَايَة
ثَلَاثُمِائةِ	ثَلْاثْمَايَة
ثَلَاثَمِائةٍ	ثَلْاثْمَايَة
ثَلَاثَمِائةِ	ثَلْاثْمَايَة
ثَلاثِمِائةٍ	ثَلْاثْمَايَة
ثَلاثِمِائةِ	ثَلْاثْمَايَة
ثَلَاثُونَ	ثَلاثُونْ
ثَلَاثِينَ	ثَلَاثِينْ
ثَمَانٍ	ثَمَان
ثَمَانِمِائةِ	ثَماْنْمَايَة
ثَمَانِمِائةٍ	ثَمَانْمَايَة
ثَمَانُونَ	ثَمَانُونْ
ثَمَانِي	ثَمَانِي
ثَمَانِيَ عَشرَة	ثَمَانِي عَشْرَة
ثَمَانِيًا	ثَمَانِيَا
ثَمَانِيَةٌ	ثَمَانِيَة
ثَمَانِيَةُ	ثَمَّانِية
ثَمَانِيَةً	ثَمَانِيَة
ثَمَانِيَةَ	ثَمَانِيَة
ثَمَانِيَةٍ	ثَمَانِيَة
ثَمَانِيَةِ	ثَمانِيَة
ثَمَانِيَةَ عَشَرَ	ثْمَانِيَة عَشْرْ
ثَمَانِينَ	ثَمَانِين
خَمسٌ	خَمَسْ
خَمسُ	خَمَّسْ
خَمسَ	خَمسْ
خَمسٍ	خَمْسْ
خَمسِ	خَمسْ
خَمسَ عَشرَة	خَمْسْ عَشْرَة
خَمسًا	خَمَسَا
خَمسَةٌ	خَمْسَة
خَمسَةُ	خَمْسَة
خَمسَةً	خَمْسَة
خَمسَةَ	خَمْسَة
خَمسَةٍ	خَمْسَة
خَمسَةِ	خَمْسَة
خَمسَةَ عَشَرَ	خَمْسَة عَشَرْ
خَمسُمَائةٍ	خَمْسْمَايَة
خَمسُمَائةِ	خَمْسْمَايَة
خَمسَمَائةٍ	خَمْسْمَايَة
خَمسَمَائةِ	خَمْسْمَايَة
خَمسِمَائةٍ	خَمْسْمَايَة
خَمسِمَائةِ	خَمْسْمَايَة
خَمسُونَ	خَمْسُونْ
خَمسِينَ	خَمْسِينْ
سَبعٌ	سَبْعْ
سَبعُ	سَبْعْ
سَبعَ	سَبْعْ
سَبعٍ	سَبْعْ
سَبعِ	سَبْعَ
سَبعَ عَشرَة	سَبْعْ عَشْرَة
سَبعًا	سَبْعَا
سَبعةٌ	سَبْعَة
سَبعَةُ	سَبْعَة
سَبعَةً	سَبْعَة
سَبعَةَ	سَبْعَة
سَبعَةٍ	سَبْعَة
سَبعَةِ	سَبْعَة
سَبعَةَ عَشَرَ	سَبْعَة عَشَرْ
سَبعُمِائةٍ	سَبْعْمَايَة
سَبعُمِائةِ	سَبْعْمَايَة
سَبعَمِائةٍ	سَبَعْمَايَة
سَبعَمِائةِ	سَبْعْمَايَة
سَبعِمِائةٍ	سَبْعْمَايَة
سَبعِمِائةِ	سَبْعْمَايَة
سَبعُونَ	سَبْعُونْ
سَبعِينَ	سَبْعِين
سِتٌّ	ست
سِتًّ	ست
سِتَّ	ست
سِتٍّ	ست
سِتِّ	ست
سِتَّ عَشرَة	ستْ عَشْرَة
سِتًّ	ست
سِتَّةٌ	سَتة
سِتَّةُ	ستة
سِتَّةً	سَتَة
سِتَّةَ	سَتْة
سِتَّةٍ	سَتَة
سِتَّةِ	سَتة
سِتَّةَ عَشَرَ	سَتَة عَشْر
سِتُّمِائةٍ	سِتْمَايَة
سِتُّمِائةِ	سَتْمَايَة
سِتَّمِائةٍ	سِتْمَايَة
سِتَّمِائةِ	سْتْمَايَة
سِتِّمِائةٍ	سِتْمَايَة
سِتِّمِائةِ	سِتْمَايَة
سِتُّونَ	سَتونْ
سِتِّينَ	سَتِيْن
عَشرٌ	عَشَرْ
عَشرُ	عَشَرْ
عَشرَ	عَشَرْ
عَشرِ	عَشَرْ
عَشرٍ	عَشَرْ
عَشرًا	عَشْرَا
عَشَرَةٌ	عَشَرَة
عَشَرَةَ	عَشَرَة
عَشَرَةً	عَشَرَة
عَشَرَة	عَشَرَة
عَشَرَةٍ	عَشَرَة
عَشَرَةِ	عَشَرَة
عِشرُونَ	عَشْرُونْ
عِشرِينَ	عَشْرِينْ
مِائَةٌ	مَايَة
مِائَةُ	مَايَة
مِائَةً	مَايَة
مِائَةَ	مَايَة
مِائَةٍ	مَايَة
مِائَةِ	مَايَة
مِائَتَا	مَايْتَا
مِائَتَانِ	مَايْتَانْ
مِائَتَي	مَايْتِي
مِائَتَينِ	مَايِتِيْن
مَلايِينٍ	مَلَايِين
مَلايينِ	مَلَايِين
مِليَارٌ	مِلْيَار
مِليَارُ	مِلْيَار
مِليَارَ	مْلْيَار
مِليَارٍ	مِلْيَارْ
مِليَارِ	مِلْيَار
مَليِارًا	مِلْيَارَا
مِليَارا	مِلْيَارَا
مِليَارَاتٍ	مِلْيَارَات
مِليِارِاتِ	مَلْيَارَات
مِليَارَانِ	مِلْيَارَان
مِليَارَيَّ	مَلْيَارِي
مِليَارَينِ	مِلْيَارِين
مِليُونٌ	مِلْيُونْ
مِليُونُ	مِلْيونْ
مِليُونَ	مِلْيونْ
مِليُونِ	مِلْيونْ
مِليُونٍ	مِلْيونْ
مِليُونًا	مِلْيونَا
مِليُونَا	مِلْيونَا
مِليُونَانِ	مِلْيونَان
مِليُونَيّ	مِلْيونِي
مِليُونَينِ	مِلْيونِين
وَاحِدٌ	وَاحِدْ
وَاحِدٍ	وَاحِدْ
وَاحِدًا	وَاحْدَا
وَاحِدَةٌ	وَاحْدَة
وَاحِدَةً	وَاحْدَة
وَاحِدَةٍ	وَاحْدَة
السَّلَامُ عَلَيكُم	السَّلَامْ عَلِيْكُمْ
السَّلَامُ عَلَيكُم وَرَحمَةُ اللهِ وَبَرَكَاتُه	السَّلَامْ عَلَيْكُمْ وَرْحْمَة الله وَبْرَكَاتُه
تِسمَحلِي	تَسْمَحْلِي
تِسمَحلِي	تَسْمَحْلِي
تِسمَحلِي	تَسْمَحْلِي
لَو تَكَرَمت	لو تَكْرَمْتْ
لَو سَمَحت عَايز	لو سَمَحْتْ عَايِز
أنَا عَايِز لَو سَمَحت	اَنَا عَايْزْ لُوْ سَمَحْتْ
لَو سَمَحت جِبلِي	لو سَمْحْتْ جِبْلِي
عَندَك حَجز	عَنْدَكْ حَجّزْ
اِستَنَّا شِوَيَّه	اِسْتْنَا شَويهْ
هَستَنَّى هِنَا	هَسْتْنَى هْنَا
المََطعَم بِيئفِل إِمتَه	الْمَطْعَم بِييْفِلْ اِمْتَهُ
المََطعَم بِيفتَح إِمتَه 	الْمَطْعِم بِيفْتَحْ اِمْتَهُ
المََطعَم دَه بِيِعمِل فِطَار	الْمَطْعِم دَه بِيَعْمَل فَطَار
هُوَّ المََطعَمدَه بِيِعمِل غَدَا وِعَشَا 	هُو الْمَطْعَمِده بِيَعْمَلْ غَدَا وَعَشَا
هُوَّ المَطعَم دَه بِيِعمِل عَشَا 	هُو الْمَطْعِم دَهْ بِيَعْمَلْ عَشَا
الصُّوت مُش وَاضِح	الصوْتْ مِشْ وَاضِح
مُش سَمعَك	مش سِمْعَكْ
أَنَا مُش سَامِع صُوتَك	اَنَا مُشْ سَامَعْ صُوتَكْ
صُوتَك وَاطِي	صُوْتِكْ وَاطِي
أَتمَنَّى التَّصحِيح	اَتْمَنى الْتَّصْحِيح
لَو سَمَحت عَدِّلهَالِي	لو سَمَحْتْ عَدْلْهَالِي
عَيزَك تِعِيد عَلَيَّ المَعلُومَات إِللِّي أُلتَهَا	عَيْزَكْ تَعِيدْ عَلِي الْمَعْلُومَات اللِي التها
عَايِز أَتكَلَّم مَعَ المَسؤُول	عَايِزْ اتْكَلِم مَعْ الْمَسوول
مِين المَسؤُول	مِيْنْ الْمَسوول
مُش فَاهِم إِنتَ بِتئُول اِيه	مِشْ فَاهِمْ اِنْتِ بِتيول اِيْه
مُش فَهِمنِي	مش فَهْمْنِي
مَفهِمتِش اِللِّي أَنَا عَيزُه	مَفْهَمْتْشْ الْلِي اَنَا عَيْزْهْ
مَا فهِمتِنِيش	مَا فَهْمْتِنِيشْ
مُش فَهمِك	مَشْ فَهْمَكْ
مُش فَهمَه إللِّي بَئُولُه	مُشْ فَهْمْهْ الْلِي بِيولْه
مَافِهِمتِيش اَنَا عَايِز إِيه	مَافْهَمْتِيشْ اَنَا عَايْزْ اَيهْ
مَافِهِمتِنِيش	مَافْهَمْتِنِيشْ
هُوَّ فِيه مَكَان لِلِّي مَا بِيدَخَّنُوش	هُو فِيهْ مَكَان لِلِي مَا بِيدْخْنُوشْ
مَعَندُكُوش قِسم لِلِّي مَا بِيدَخَنُوش	مَعْنْدْكُوشْ قَسْمْ لِلِي مَا بِيدْخْنُوشْ
أنا عَايِز المَكَان المُخَصَّص للِّي مَا بِيدَخَّنُوش	اَنَا عَايِزْ الْمَكَان الْمَخْصِصْ لِلِي مَا بِيدْخْنُوشْ
فَين المَكَان المُخَصَص للِّي مَا بِيدَخَّنُوش	فِينْ المَكَان الْمَخَصِصْ لِلِي مَا بِيدْخْنوشْ
فِين المَكَان المُخَصَّص لِلمُدَخِّنِين	فِينْ الْمَكَان الْمَخْصِصْ لِلْمُدْخْنِينْ
مَعلِش أَنَا آسِف	مَعْلَشْ اَنَا اَسَّفْ
مَعلِش أَنَا آسِف	مَعْلَشْ اَنَا اَسَّفْ
لَو تَكرَّمت	لو تَكْرَمْتْ
تِسمَحلِي	تَسْمَحْلِي
اَيوَه	اَيوهْ
لَأَّه	لَاهْ
حَاضِر	حَاضِر
طَيِّب	طِيْبْ
شُكرًا	شَكْرَا
شُكرًا	شَكْرَا
شُكراً	شَكْرَا
مُش عَايِز	مِشْ عَايِزْ
مُش آدِر	مِشْ اَدْرْ
مُش عَايِز	مِشْ عَايِزْ
أَنَا آسِف	اَنَا اَسَّفْ
سَامحنِي	سَامْحْنِي
سَامحِينِي	سَامْحِينِي
أَنَا آسِف جِداً	اَنَا اَسْفْ جَدَا
إِيه نُوع البُهَرَات إللِّي فِي السَّلَطَه	اَيْهْ نُوَعْ الْبَهْرَات الْلِي فِي السُلْطَه
إِيه هِّيه أنوَاع السَّلَطَات عَندُكُم	اَيْه هِيهْ اَنْوَاعْ السُلْطَاتْ عَنْدْكُم
إِيه أنوَاع السَّلَطَات اللِّي بِتأدِّمُوها	اَيْهْ اَنْوَاعْ السُّلْطَاتْ الْلِّي بِتَادْمُوهَا
لو سَمَحتِ عَايِز أَهوَه	لو سَمْحْتْ عَايِزْ اَهُوهُ
عَايِز فِنجَان أَهوَه	عَايِزْ فَنْجَانْ اَهوهْ
هَاتِ الأَهوَه الاَوَّل	هَاتْ الْاَهُوهْ الْاَوَّل
هَاتِيلِي الأَهوَه	هَاتِيلِي الْاَهوه
لَو سَمَحتِي عَايِز شَاي	لو سِمْحْتِي عَايِزْ شَاي
عَايِز فِنجَان شَاي الأَوَّل	عَايِزْ فَنْجَانْ شَايْ الاَوَّل
اعمِليلنَا الشَّاي بَعدِ العَشَا	اَعْمِلِيلْنَا الْشَايْ بَعَدْ الْعَشَا
لَو سَمَحتِ عَايِز الاَكل دِلوَئتِي	لو سَمْحْتْ عَايِزْ الْاَكلْ دَلوِيتِي
هَاتِ السَّلَطَه أَبل الَأَكل	هَاتْ السَّلْطهْ اَبْلْ الاَكُل
عَايِز إسبِرَايِت	عَايِزْ اِسْبَرَايِتْ
عاَيِز كُوكَاكولَا	عَايِزْ كُوكَاكُولَا
هَاتِلنَا بِبسِي	هَاتْلْنَا بِبْسِي
عَايِز شوَيَّة وَأت لِتَجهِيز الاَكل	عَايِزْ شْوََيَّة وَاتْ لِتْجْهِيز الاَكَلْ
عَايِز المِنيُو	عَايِزْ الْمَنِيو
أَنَا لِسَّه مُش جَاهِز لِطَلَبِك دِلوَئتِي	اَنَا لِسْهْ مُشْ جَاهِزْ لِطْلْبْكْ دَلْوِيتِي
لِسَّه مَخَتِّش قَرَار	لِسهْ مُخْتِشْ قَرَارْ
أدِّينِي شوَية وَئت عَلَشَان أقَرَّر	اَدِينِي شُوِيَّة وَيْتْ عَلْشَانْ اَقْرِرْ
عَايِز شويِّة وَئت عَلَشَان أقَرَّر	عَايِزْ شُويَّة وَيْتْ عَلْشَانْ اَقْرَرْ
إِيه أَنوَاع الأَكَل عَندُكُو	اَيْه اِنْوَاعْ الْاَكِل عَنْدْكُو
إِيه رَايَك نَاكُل إيه	اَيْهْ رَايْكْ نَاكُلْ اَيْه
الفِطَار	الْفَطَارْ
شُوربَة خُضَار مَع زِيت زَيتُون	شورْبَة خَضَارْ مَعْ زِيتْ زِيتُونْ
عَسَل وِجِبنَه وِمُرَبَّى الفَرَولَه	عَسَلْ وَجْبْنْهْ وْمَرْبَى الْفَرُوله
حَلَاوَة طِحِينِيَّة مَعَ زِبَدَةِ الفُول السُّودَانِي	حَلَاوَة طَحِينِيَة مَعْ زِبْدَة الفُول السُّودَانِي
إِيه رَايَك نَاكُل إيه	ايه رَايِكْ نَاكُلْ اَيَّه
عَندُكُو شوربِة اِيه النِهَردَه	عَنْدْكُو شُورْبَة اَيْهْ النّهْرْدْه
إِيه طَبَأ إِنَّهردَه	اِيْهْ طَبَّا اِنْهَرْده
فِرَاخ مَشوِيَّه	فَرَاخْ مَشوِيه
لَحمَهَ مَعَ رُّز	لَحَمْه مَعْ رَزْ
رُزّ و لَحمه	رَزْ وْ لِحْمْهْ
رُزُّ وفِرَاخ	رَزْ وَفْرَاخْ
مَشوِيَّات مِشَكِّلَه	مَشوِيَاتْ مَشْكِله
أَكَلات بَحرِيَّة	اَكْلَاتْ بِحْرِيَة
بِالنِّسبَالِي بَفَضَّل الاَكل النَّبَاتِي	بِالْنِّسْبَالِي بِفَضَلْ الْاَكْل الْنِّبَاتِي
صِحَّة وِعَافيَة	صَحَّة وَعَافِيَة
عَايِز خُبز	عَايْزْ خَبْزْ
عِيش كَمَان	عَيْشْ كَمَانْ
تِنصَحنَا بِإِيه	تَنْصَحْنَا بَايِهْ
تِنصَحِينِي بِإِيه	تَنْصَحِينِي بَايْهْ
إِيه أحسَن وَجبَه عَندُكُو	اَيْه اَحْسَنْ وَجْبْهْ عَنْدْكُو
أحسن الوَجَبَات عَندُكُو	اَحْسَنْ الْوَجْبَاتْ عَنْدْكُو
هَاتِ السَّلَطَات وبَعدِين هَات الاَكل	هَاتْ السَّلْطَاتْ وَبَعْدِينْ هَاتْ الاَكُلْ
عَندُكُو بُوفِيه مَفتُوح	عَنْدْكُو بُوفِيهْ مَفْتُوحْ
إيه الأَنوَاع إللِّي بِتئَدِّمُوهَا فِي البُوفِيه المَفتُوح	اَيْه الْاَنْوَاع اللِي بِتيدْمُوهَا فِي الْبُوفِيه الْمَفْتُوح
هُوَّ كُلِّ الأنوَاع حَلَال	هُو كُلْ الاَنْوَاع حَلَال
إِيه أنوَاع العَصَائِر إللِّي عَندُكُو	اَيْهْ اِنْوَاعْ الْعَصَايِر الْلي عَنْدْكُو
عَصِير بُرتُئَان	عَصِيْرْ بِرَتِيَان
فُول وعَدس	فَولْ وَعَدْسْ
عِيش فِينُو وعِيش عَادِي	عَيْشْ فِينُو وَعِيْشْ عَادِي
أَربَعه تَمِيس	اَرْبَعَه تْمِيْسْ
فُول وِمطَبَّأ	فَوَّلْ وَمْطَبَا
عَصِير مِشَكِّل	عَصِيْر مَشَكِلْ
عَصِير فَوَاكِهَ مشَكَّلَة	عَصِيرْ فَوَاكُه مُشْكِلَة
عَصِير بُرتُآن وِلَيمُون	عَصِير بَرْتَان وَلِيمُونْ
تَلَت أَرغِفِة	تِلْتْ اَرْغَفَة
رِغِيفِين عِيش	رَغِيْفِينْ عَيْش
رِغِيف عِيش	رَغِيفْ عَيْشْ
سِكِّينَه	سَكِينْه
شَوكَه	شوكْه
مَعلَأَه	مَعْلَاهْ
مَعلَأه صُغَيَّرَه	مَعْلَاهْ صَغِيْرْه
طَبَأ	طَبَا
طَبَأ كِبِير	طَبَا كْبِيرْ
طَبَأ صُغَيَّر	طَبَا صَغِيرْ
أَنَا جَعَان	اَنَا جَعَانْ
أَنَا عَطشَان	اَنَا عَطَشَانْ
عَايِز مَيَّه	عَايْز مِيهْ
حُمُّص	حَمَّصْ
كَبَاب	كَبَابْ
أورَاك	اورَاكْ
شُوربَة عَدس	شورِبَة عَدْسْ
شُوربَة خُضَار	شورْبَة خَضَارْ
شُوربَة فِرَاخ	شورْبَة فْرَاخْ
شُوربَة حَرِيرَة	شورْبَة حَرِيرَة
عَسَل	عَسَلْ
جِبنَه	جَبْنَهُ
سَلَطَات	سُلْطَاتْ
حَلَاوَه	حَلَاوْهُ
الأَكل مَكَنش حِلو	الْاَكْل مَكْنْشْ حَلُّو
العَشَا كَان لَذِيذ	الْعَشَا كَان لِذِيْذ
دَا مِن افضَل الاَطبَاء إللِّي دُئتَهَا	دَا مِنْ اَفْضَل الْاَطْبَاء اللِي دِيتَهَا
كَان أَحسَن طَبَأ دُئتُه	كَان اَحْسَنْ طَبَا دِيْتَه
الطَّبَأ دَا لَذِيذ	الطَبَا دَا لِذِيذْ
الطَّبَأ دَا مَكَنشِ بِالمَستَوَى المَطلُوب	الطِبَا دَا مَكْنِشْ بِالْمُسْتَوَى الْمَطْلوبْ
المَطعَم دَا رَائِع	الْمَطْعِم دَا رَايَعْ
المَطعَم مِن أَفضَل المَطَاعِم إللِّي زُرتَها	الْمَطْعَم مِنْ اَفْضَلْ المَطَاعِم الْلِّي زَرْتَهَا
تَعَامُلكُم كَان رَائِع	تَعَامْلْكُم كَان رَايَعْ
مُوَظَّف الاستِئبَال كَان لَطِيف	مُوَظْفْ الْاِسْتِيبَال كَان لِطِيفْ
المَطعَم دَه مُش مُرِيح	الْمَطْعِم دَه مِشْ مَرِيحْ
صُوت المُوسِيقَى عَالِي جَدَّاً	صَوْتْ الْمُوسِيقَى عَالِي جِدَا
الجَوّ رَائِع فِي المََطعَم	الجَوّ رَايِعْ فِي الْمَطْعْمْ
بَحِب المَطعَم ده	بِحِبْ الْمَطْعِمْ دَهْ
رَائِحَةُ الدُّخَّانِ مُزعِجَه	رَايْحَة الْدَّخَانْ مَزْعَجَه
مُمتَاز	مُمْتَازْ
مُتَوَسِّط	مَتْوَّسْطْ
رَائِع	رَايَعْ
مُش جَيّد	مِشْ جِيْدْ
مُش مُرضِي	مش مَرْضِي
مُش مُرِيح	مشْ مَرِيحْ
فِين الحَمَّامَات	فِينْ الْحَمَامَاتْ
فِين الحَمَّام	فِينْ الْحَمَام
عَايِز دُورة المَّيه	عَايِزْ دُورَة الْمِيهْ
مُمكِن اَغسِل إِيدِي فِين	مُمْكِنْ اَغْسَلْ اِيْدِي فِينْ
عَايِز آخُد الأكل بَرَّه المَطعَم	عَايِزْ اَخَد الاَكْل بَرَه الْمَطْعَمْ
مُمكِن آخُد دَه بَرَّه المَطعَم	مُمْكِنْ اَخْدْ دَهْ بَرَه الْمَطْعِم
اِتفَضَّلِ الطَّلَب	اَتْفَضَل الطَّلْبْ
هاخُد البَائِي مِ الاَكِل مَعَايَا	هَاخِد الْبَايِي مْ الْاَكْل مَعَايَا
عَايز طَرَبِيزه لِشَخصِيِن	عَايِزْ طَرْبِيزُه لِشْخْصينْ
أَنَا حَاجِز	اَنَا حَاجِزْ
عَندِى حَجز فى المَطعَم	عَنْدَى حَجْزْ فَى الْمَطْعَم
عَايِز طَرَبِيزَه لأَربَع أَشخَاص	عَايِزْ طَرْبِيزُه لِاَرْبَعْ اَشْخَاصْ
عَايِز طَرَبِيزَه لِتَلَت أشخَاص	عَايِزْ طَرْبِيزُهْ لِتَلْتْ اَشْخَاصْ
مَندِيل	مِنْدِيلْ
مَنَادِيل	مَنَادِيلْ
أَطبَاء	اَطْبَاءْ
طَبأ كِبِير	طِبَا كْبِيرْ
طَبَأ صُغَيَّر	طَبَا صَغِيرْ
مَعلَئَه	مَعْلِيهْ
مَعلَئَه كِبِيرَه	مَعْلِيهْ كَبِيرَه
مَعلئه صُغَيَّرَه	مَعْلِيهْ صَغِيرُه
مَندِيل لِلمَسح	مِنْدِيل لِلْمَسْحْ
أَطبَاء	اَطْبَاءْ
طَبَأ	طَبَا
كُبَّايِه	كَبَايِهْ
تَلَت اطبَّاء	تِلْتْ اَطْبَاء
مَعَلئتِين	مَعْلِيتِيْن
طَبَأ كِبِير ومَعلَئَه	طَبَّا كْبِير وَمَعْلِيهْ
طَرَبِيزَه كِبِيرَه	طَرْبِيزُه كَبِيرَهْ
طَرَبيزَه صُغَيرَه	طَرَبِيزُه صَغِيْرَه
هَات الحِسَاب	هَاتْ الْحَسَاب
عَايِز الحِسَاب	عَايِزْ الْحَسَاب
فِين الحِسَاب	فِينْ الْحَسَابْ
فِين حِسَاب الأكل	فِينْ حِسَابْ الْاَكُل
فَاتُورَة لِكُل شَخص لَو سَمَحت	فَاتُورَة لكلْ شَخْصْ لو سَمْحْتْ
مُمكِنُ الإِيصَال لَو سَمَحتِي	مُمْكِنْ الْايْصَال لو سْمَحْتِي
فِيه خَطَأ فِي الفَاتُورَه	فِيهْ خَطَّا فِي الفَاتُورَه
فَيِن الفَاتُورَه بِالتَّفصِيل	فِينْ الْفَاتُوره بِالْتَّفْصِيل
مَطَلَبتِش دَه	مَطْلَبْتْش دَه
مَطَلَبتِش الصَّنف دَه	مَطْلْبْتْشْ الصَّنْف دَهْ
خَلِّي البَائِي عَلَشَانَك	خَلِّي الْبَايِي عَلَشَانِكْ
الغَدَا بِكَام	الْغَدَّا بِكَام
المَجمُوع كُلُّه كَام	الْمَجْمُوعْ كُله كَام
العَشَا بِكَام	الْعَشَا بِكَامْ
هُوَّ البُوفِيه المَفتوح بِكَام	هُو الْبُوفِيهْ الْمَفْتُوح بِكَام
هُوَّ فِيه رُسُوم لِلخِدمَه	هُو فِيهْ رَسومْ لِلْخَدْمْهْ
بِتشتَغَلُو يُوم الخَمِيس	بِتْشْتَغْلُو يومْ الْخَمِيسْ
هِوَّالمَطعَم بِيفتَح يَوم الجِمعَه	هوالْمَطْعْم بِيفْتَح يُومْ الجُمْعه
السَّلَامُ عَلَيكُم وَرَحمَةُ اللهِ وَبَرَكَاتُه	السَّلَامْ عَلَيْكُمْ وَرْحْمَة اللَه وَبْرَكَاتُه
السَّلَامُ عَلَيكُم	السَّلَامْ عَلِيْكُمْ
السَّلَامُ عَلَيكُم وَرَحمَةُ الله	السَّلَامْ عَلَيْكُمْ وَرْحْمَة الله
مَسَاء الخِير	مَسَاءْ الْخَيْر
صَبَاح الخِير	صَبَاح الْخَيْر
مَسَاء الخَيرَات	مَسَاء الْخَيْرَاتْ
أَنَا حَاجِز	اَنَا حَاجِزْ
عَندِي حَجز فِي الفُندُء دَا	عَنْدِي حَجْزْ فِي الْفِنْدِءْ دَا
حَجَزت الغُرفَه رَقم	حَجْزَت الْغَرْفه رَقَمْ
غُرفِتِي رَقم	غَرفتِي رَقَمْ
غُرفَة لِشَخص وَاحِد	غُرْفَة لِشْخْصْ وَاحِد
غُرفَة لِشَخصَين	غُرْفَة لِشْخْصينْ
غُرفَة لِتَلَت أَشخَاص	غُرْفَة لِتَلْتْ اَشْخَاصْ
عَايِز غُرفَه لِشَخص وَاحِد	عَايِزْ غَرْفِه لِشَخْصْ وَاحِد
عَايِز جِنَاح عَائِلِي	عَايِزْ جِنَاحْ عَايِلِي
بَدَوَّر عَلَى شَأَّه	بِدُوْر عَلَى شَاهْ
أُوضه بِسرِير مُزدَوَج	اَوْضَهْ بَسْرِير مَزْدَوجْ
أُوضه بِسرِيرِين	اَوْضَهْ بِسْرِيرِين
جِنَاح خَاصّ مَعَ حَمَّامِين	جَنَاح خَاصْ مَعْ حَمَامِين
تَلَت حَمَّامات	تَلْتْ حَمَامَاتْ
أَربَع حَمَّامات	اَرْبَعْ حَمَامَاتْ
جِنَاح خَاصّ مَعَ مَجلِس وغُرفَة لِاستِئبَال الضُّيُوف	جِنَاحْ خَاصْ مَعْ مَجْلِس وْغُرْفَة لِاَسْتِيبَال الضّيوفْ
تَلَت غُرَف نُوم مَعَ حَمَّامين	تِلْتْ غَرَف نُومْ مَعْ حَمَامِينْ
غُرفِتِين نُوم مَعَ حَمَام	غرَفْتِينْ نُومْ مَعْ حَمَام
الصُّوت مُش وَاضِح	الصَّوْتْ مِشْ وَاضِح
مُش سَمعَك	مشْ سَمْعَكْ
مُش آدِر اسمَع صُوتَك	مِشْ اَدْرْ اَسْمَعْ صُوتَكْ
عَايِز اَتكَلِّم مَعَ المَسئُول	عَايِزْ اَتْكَلْمْ مَعْ الْمَسِيول
عَايِز أتكَلِّم مَعَ وَاحِد تَانِي	عَايِزْ اِتْكَلْم مَعْ وَاحَد تَانِي
يَارِيت التَّصحِيح	يَارِيتْ الْتَّصْحِيحْ
أَرجُو التَّعدِيل	اَرْجُو الْتَعْدِيل
بَدَوَّر عَلَى فُندُء	بِدُور عَلَى فَنْدَءْ
أَنَا بَدَوَّر عَلى فُندُء	اَنَا بِدور عَلَى فَنْدَءْ
مُمكِن تِسَاعِدنِي أَدَوَّر عَلى فُندُء	مُمْكِنْ تَسَاعِدْنِي اَدُّورْ عَلَى فَنْدِءْ
لَو سَمَحت مُمكِن تِعِيد عَلَيَّ المَعلُومات إللِّي أَنَا اُلتَهَا	لو سَمْحْتْ مُمْكِنْ تَعِيدْ عَلِي الْمَعْلُومَاتْ اللي اَنَا التَهَا
مُش فَاهِم إللِّي أَنَا بَئُولُه	مُشْ فَاهَمْ الْلِّي اَنَا بِيُوله
مَفهِمتِش إللِّي أنَا عَايزُه	مِفْهَمْتْشْ الْلِي اَنَا عَايْزَهْ
مَفهِمتِنِيش	مِفْهَمْتِنِيشْ
مُش فَاهِم إللِّي بِتَئُولِيه	مُشْ فَاهَمْ الْلِّي بِتيولِيهْ
مُشَ فَاهِمه إللِّي أَنَا بَئُولُه	مُشْ فَاهْمْهْ الْلِّي اَنَا بِيُوله
مَفهِمتِيش إللِّي أَنَا عَايزُه	مِفْهَمْتِيشْ الْلِي اَنَا عَايْزْه
مَفهِمتِينِيش	مِفْهَمْتِينِيشْ
جِنَاح	جِنَاحْ
شَئَّة	شِيَة
غُرفَة	غُرْفَة
غُرفِتِين	غَرفَتِينْ
تَلَت غُرَف	تِلْتْ غَرَفْ
حَمَّام	حَمَامْ
دُورِة مَيَّه	دورَة مِيْهْ
مَطبَخ	مَطَبْخَ
صَالَة	صَالَة
مَمَرّ	مَمَّرْ
سِرِير	سَرِيرْ
طَرَبِيزَه	طَرْبِيزْه
عَايِز خَدَمَات غَسِيل الهِدُوم	عَايِزْ خَدْمَاتْ غَسِيلْ الْهُدُوم
تَحوِيلِة مَغسَلَة المَلَابِس	تَحْوِيلَة مَغْسِلَّة الْمَلَابِسْ
خَدَمَات تَنظِيف الغُرَف	خَدَمَاتْ تَنْظِيفْ الْغَرَفْ
مَسئُول تَنظِيف الغُرَف	مَسْيولْ تَنْظِيفْ الغَرَفْ
عَايِز الغُرفَه	عَايْزْ الغَرْفه
تَحوِيلِة نَظَافِةَ الغُرَف	تَحَوِيلَة نِظَافَة الْغَرَفْ
كَم رَقَم تَحوِيلِة	كُمْ رَقَّمْ تَحْوِيلَة
مُمكِن تِدِّينى رَقَمَ تَحوِيلِة مَغسَلِة المَلَابِس	مُمْكِنْ تْدِينَى رَقَمْ تَحْوِيلَة مَغْسَلَة الْمَلَابِسْ
عَايِز رَقَم تَحويلِه خَدَمَات الغُرَف	عَايْزْ رَقَّمْ تَحَوِيله خَدَمَاتْ الغَرَف
مِين هُوَّه المَسئُول عَن	مِيْنْ هُوهْ الْمَسْيولْ عَنْ
مِين المَسئُول عَن	مِينْ الْمَسْيولْ عِنْ
خَدَمَات الغَسِيل	خَدَمَاتْ الْغَسِيلْ
الغَسَّالَة	الْغَسَالَة
مَغسَلِة المَلَابِس	مَغْسِلَة الْمَلَابِس
المَطعَم	الْمَطَعَمْ
البَنك	الْبَنْكْ
السُوء	السُّوءْ
السُّوبَر مَاركِت	السُّوبْر مَارْكِتْ
الحَمَام	الْحَمَام
الحَمَّام	الْحَمَامْ
خَدَمَاتُ الغُرَف	خَدَمَاتْ الغَرَف
هُوَّ فِيه حَمَّام جَاكُوزِي	هُو فِيهْ حَمَام جَاكُوزِي
هُوَّ فِيه حَمَّام بُخَار	هُو فِيهْ حَمَام بِخَار
عَايِز حَمَّام بُخَار	عَايِزْ حَمَام بِخَارْ
هُوَّ فِيه مَسبَح فِي الفُندُء	هُو فِيهْ مَسْبَح فِي الْفَنْدِءْ
لَو سَمَحت هُوَّ فِينِ المَسبَح	لو سَمْحْتْ هُو فِينْ الْمَسْبَحْ
عَايِز أَسبَح	عَايِزْ اسْبَحَ
فِين حَمَّام السِّبَاحَة	فِينْ حَمَام الْسَّبَاحَة
هُوَّ فِيه مَسبَح خَاصّ بالاَطفَال	هُو فِيهْ مَسْبَح خَاصْ بِالاَطْفَال
مَسَابِح لِلأَطفَال	مَسَابِحْ لِلْاَطْفَال
إِيه أَنوَاع المَطَاعِم المَوجُودَه فِي الفُندُء	اَيْهْ اَنْوَاعْ الْمَطَاعِم الْمَوجُودهْ فِي الْفَنْدِءْ
هُوَّ فِيه مَطَعَم بَحرِي	هُو فِيهْ مَطْعَمْ بِحْري
مَطَاعِم صِينِيَّة	مَطَاعِمْ صَيْنِيَّة
مَطَاعِم لِلأَكل الحَلَال	مَطَاعِمْ لِلْاَكِل الْحَلَال
هُوَّ جَمِيع ألاَصنَاف حَلَال	هُو جَمِيعْ الْاَصْنَاف حَلَال
هُوَّ فِيه أَسوَاء جُوَّه الفُندُء	هُو فِيهْ اَسْوَاء جُوه الْفَنْدِءْ
إِيه أَأرَب مَركَز للتَّسَوُّق	اَيْهْ اارَبْ مَرْكَزْ لِلْتَسْوِقْ
مَرَاكِز للتَّسوِيق أُرَيبَة مِن الفُندُء	مَرَاكِز لِلْتَسْوِيق اَرِيبَة مِنْ الْفِنْدِءْ
إِيه أأرَب مَرَاكِز التَّسَوُّق للفُندُء	اَيْه اارَب مَرَاكِزْ الْتَسَوُّقْ لِلْفَنْدِءْ
أأرَب المَطَاعِمَ لِلفُندُء	اَاْرَبْ الْمَطَاعمْ لِلْفِنْدِءْ
هُوَّ فِيه صَرَاف آلي	هُو فِيهْ صْرَافْ اِلْي
عَايز صَرَّاف آلِي	عَايِزْ صَرَافْ اِلْي
هُو فِيه عَندُكُم مَسَاج	هُو فِيهْ عَنْدْكُم مَسَاج
مَسَاج لِلضَّهَر	مَسَاج لِلْضَّهْر
عَايِز المَسَاج	عَايْزْ الْمَسَاج
مَسَاج	مَسَاج
مَسبَح	مَسْبَحْ
قَاعَة	قَاعَة
فُندُء	فِنْدْءْ
صَرَّاف	صَرَاف
حَدِيقَة	حَدِيقَة
بَهو	بَهُو
مَركَز تَسَوُّء	مَرْكَزْ تَسوْءْ
حَدِيقَة عَامَّة	حَدِيقَة عَامَة
الّليلة بِكَام	اللِيلَة بِكَام
كَم إِجمَالِيّ الفَتُورَة	كُمْ اِجْمَالِي الْفَتُورَة
إِجمَالِيّ الإِقَامَة	اَجْمَالِي الْاَقَامَة
اِديِنِي الفَتُورَةَ مِن فَضلِك	اِدِينِي الْفِتورَة مِنْ فِضْلِكْ
هِو مُمكِن ادفَع كَاش	هُو مُمْكِنْ اَدْفَعْ كَاشْ
عَايِز أَدَفع كَاش	عَايِز ادْفَعْ كَاشْ
هُو اِنتُوا بِتئبَلُو الشِّيكَات	هُو اِنْتُوا بِتِيبْلُو الشِّيْكَات
هُو مُمكِن أَدفَع بِشِّيك	هُو مُمْكِنْ اَدْفَعْ بَشيكْ
شِّيك مُصَدَّق	شِيكْ مَصْدَقْ
هَدّفَع بِالبِطَائةِ الائتِمَانِيَّة	هَدَفَعْ بِالْبْطَايَة الْاَيْتِمَانِيَة
هَحَاسِب بِالفِيزَا	هَحَاسِبْ بِالْفِيزَا
هُوَّ دَا شَامِل كُل مَصَارِيف الِاقَامَه	هُو دَا شَامِل كُلْ مَصَارِيفْ الْاَقَامِه
هُوَّ إِنتَ ضِفت حِسَاب الوَجَبَات	هُو اِنْتِ ضَفْتْ حَسَاب الوَجْبَاتْ
عَايِز فَتُورَه لِوَحدَهَا	عَايِزْ فْتُوره لِوَحْدَهَا
كُل فَتُورَه لِوَحدَهَا	كُلْ فْتورهْ لِوَحْدَهَا
عَايِز الِايِصَال لَو سَمَحت	عَايْزْ الْايْصَال لوْ سَمَحْتْ
لَو سَمَحت أَدِّينِي الفَوَتِير كَاملَه	لو سَمَحْتْ اِدِينِي الْفُوتِير كَامْلْه
أدِّينِي الإِيصَال	اَدِينِي الْاَيْصَال
فَاتُورَة	فَاتُورَة
شِيك	شِيكْ
كَاش	كَاشْ
صَرَّاف	صَرَاف
بِطَاقَة	بِطَاقَة
كَاش	كَاشْ
مَاستَر كَارد	مَاسْتِرْ كَارْدْ
فِيزَا كَارد	فِيزَا كَارِدْ
مَاستَر كَارد	مَاسْتِرْ كَارْدْ
أَمرِيكَان إِكسِبرِس	اَمْرِيكَان اَكْسَبِرِس
فِيزَا دِبِت	فِيزَا دَبْتْ
وَصل	وَصَلْ
جَدوَل مَوَاعِيِد الرَّحَلَات	جَدول مُوَاعِيْدْ الرَحْلَات
عَايِز أَعرَف مَواعِيِد رَحَلَات المُغَادره	عَايِزْ اَعْرَفْ مَوَاعِيْدْ رَحَلَاتْ الْمَغَادِرَه
عَايِز أَسَافِر مِن الرِيًاض إِلى	عَايِزْ اِسَافِرْ مِنْ الرِيَاضْ اِلَى
عَايِز أَسَافِر مِن	عَايْزْ اَسَافِر مِنْ
عَايِز أَسَافِر إِلى	عَايْزْ اِسَافِرْ اَلْى
إِمتَه هَتِوصَل الرِحلَه	اِمْتَهْ هَتْوَصِلْ الرَحَله
كَام عَدَد الرَحَلاَت إِلِّي جَايَّه	كَام عَدَدْ الرَحْلَاتْ اِلْي جَايَهْ
كَام عَدَد الرَّحَلاَت المُغَادره	كَام عَدَدْ الرَحْلَاتْ الْمَغَادِره
عَايِز أَعرَف مَوَاعِيِد رَحَلاَت المُغَادرَه	عَايِزْ اَعْرَفْ مَوَاعِيْدْ رَحَلَاتْ الْمَغَادِرْه
عَايِز أَعرَف مَعَاد رِحله جَدَه	عَايْزْ اَعْرَفْ مَعَادْ رَحْلَه جِدْهَ
إِمتَه هَتُوصَل الرِحله رَقَم واحِد اتنِين تَلَاتَه	اِمْتَه هَتْوَصِلْ الْرَّحْلهْ رَقَمْ وَاحِد اِتْنِين تَلَاته
مَعَاد وِصُول الرِحله رَقَم	مَعَادْ وَصولْ الرّحْلهْ رَقَمْ
مِعَاد وِصُول الرِحله رَقَم تَلَاتَه اِتنِين وَاحِد	مَعَادْ وَصولْ الرَّحْلهْ رَقَمْ تَلَاتِه اِتْنِينْ وَاحِد
أَرجُو التَّعدِيل	اَرْجُو الْتَعْدِيلْ
عَدِّل الحَجزَ لَو سَمَحت	عَدْلْ الْحَجْزْ لَو سَمْحَتْ
غَيِّر مَوعِدَ الحَجّز إلى	غِيْرْ مَوَعْدْ الْحَجْزْ اِلَى
هُو إِيه رَقَم الحَجّز	هُو اَيْهْ رَقَّمْ الْحَجِزْ
لَو سَمَحت عِيِد عَلَيَّ المَعلُومَات إللِّي أُلتَهَا	لو سَمَحْتَ عَيْدْ عَلِي الْمَعْلُومَاتْ اللِّي التَهَا
عَايِز أَتكَلِم مَع المَسئُول	عَايِزْ اَتْكَلْمْ مَعْ الْمَسْيول
عَايز أَتكَلِم مَع وَاحِد تَانِي	عَايِزْ اِتْكَلْم مَعْ وَاحِد تَانِي
عَايز أَسَافِر إِلَى	عَايْزْ اَسَافِرْ اَلْى
عَايِز أَلغِي الحَجز	عَايِزْ الغِي الْحَجّزْ
الحَجز مُش مُنَاسِب	الْحَجِّزْ مُشْ مَنَاسِبْ
عَايِز أَدفَع تَمَن التَذكَرَه	عَايِزْ ادْفَعْ تَمْنْ التَّذْكرْه
كَم مَجمُوع تَمَن التَذَاكِر	كُمْ مَجْمُوعْ تَمْنْ الْتَذَاكِرْ
مَجمُوع التَمَن	مَجْمُوعْ التَمْنْ
كَم السِّعر الكُلِّي	كُمْ السَّعْرْ الْكَلِي
عَايِز أَدفَع فِلُوس التَذكَرَة دِلِوَئتِي	عَايِزْ ادْفَعْ فِلُوسْ التَّذْكْرَة دِلوِيتِي
هَدفَع بِالبِطَائَه الِإئتِمَانِيه	هَدَفَعْ بِالْبَطَايِه الْاَيْتِمَانِيهْ
هُوَّ إِيه رَقَم التَذكَره الإلِكتُرونِيَه	هُو اَيْه رَقَمْ الْتَذْكِرْه الْاِلْكَتْرُونِيه
إِيه هِوَّا رَقَم التَذكَرَه الإلِكتُرونِيَه	اَيَّهْ هُوَا رَقَمْ الْتَذْكُرْه الْاِلْكَتْرُونِيهْ
اِطبَع كَرتَ الصُّعُودِ لِلطَّائِرَة	اَطْبَعْ كُرْتْ الصّعودْ لِلْطَايِرَة
عَيزَك تِطَلَع كَرتَ الصُّعُود	عيْزَكْ تَطْلِعْ كَرْتْ الصعودْ
غَيِّرِ المقَاعِدَ لَو سَمَحت	غَيْر الْمَقَاعِدْ لو سَمْحْتْ
عَايِز أَغَيَر المَقَاعِد	عَايِزْ اَغِيرْ الْمَقَاعِدْ
تِئدَر تِأَكِّدِ الحَجز دَه	تِيدَرْ تَاكِدْ الْحَجْزْ دَهْ
جَمب الشِّبَاك	جَمْبْ الْشِّبَاكْ
عَلَى المَمَر	عَلَى الْمَمْرْ
جَمب مَخرَج الطَوَارِئ	جَمْبْ مَخْرَجْ الطَّوَارِي
حَجز	حَجَزْ
تَذكَرَة	تَذْكْرَة
كَرتُ صُعُود	كرت صَعُودْ
رَقم	رَقَمْ
شِّبَاك	شَبَاكْ
الرِّحلَة	الرَّحْلَة
كَم رَقَم بَوَّابَةِ الدُّخُول	كُمْ رَقَّمْ بْوَابَة الدُّخُول
عَايِز أَعرَف رَقَم البَوَابَه	عَايِزْ اَعْرَفْ رَقَمْ الْبُوابْه
رَقم الحَجز لَو سَمَحت	رَقَمْ الْحَجْزْ لو سَمَحَتْ
عَايِز رَقَم الحَجز	عَايِزْ رَقَمْ الْحَجِزْ
عَايِز أَعرَف رَقَم الحَجز	عَايِزْ اَعْرَفْ رَقَمْ الْحَجِزْ
عَايِز أَعرَف رَقَم الرِّحلَه	عَايِزْ اَعْرَف رَقْمْ الرَحْله
عَايِز أَعرَف رَقَم الصَالَه	عَايِزْ اَعْرَف رَقَمْ الْصَالِه
عَايِز أَأَكِّد الحَجِز	عَايْزْ اَاكَد الْحَجِزْ
عَايِز أَعرَف وَئت الرِّحلَه	عَايِزْ اَعْرَفْ وَيْتْ الرَحْله
عَايِز أَعرَف وَئت وصُول الرِّحلَه	عَايِزْ اَعْرَفُ وِيْتْ وَصَولْ الرَّحْله
الصُوت مُش وَاضِح	الصَوْتْ مِشْ وَاضِح
مُش سَمعَك	مشْ سِمْعَكْ
مُش آدِر أَسمَع صُوتَك	مِشْ اَدْرْ اَسْمَعْ صُوْتَكْ
صُوتَك وَاطِي	صَوْتِكْ وَاطِي
حَجز جِدِيد لَو سَمَحت	حَجْزْ جْدِيدْ لو سَمَحْتْ
عَايِز أَعرَف وَئت مُغَادَّرَه الرِحلَه	عَايِزْ اَعْرَفْ وَيْتْ مَغَادِره الرَحْله
هِيِا الرِحلَه إِتأَخَرت	هِيَا الرَّحْله اَتَاخَرَتْ
هِيَّ الطَيَاره هَتِطلَع فِى مَعَدهَا	هِي الطَّيَارَه هَتْطَلَع فَى مَعَدْهَا
الرِحلَه فِي مَعَدهَا	الْرَّحْله فِي مَعْدَهَا
الرِحلَه اِتأَخَرِت سَعتِّين	الرحْله اَتَاخَرْتْ سَعْتِينْ
الصَّالَةُ المَحَلِيَّة	الصَالَة الْمَحَلِيَّة
الصَّالَةُ الدَّاخِلِيَّة	الصَالَة الْدَّاخْلِيَّة
الصَّالَةُ الدَّولِيَّة	الصَالَة الدُّولِيَة
الصَّالَات الدَّولِيَّة	الصَالَات الدُّولِيَة
صَالَةُ المُغَادَرَة	صَالَة الْمَغَادِرَة
صَالَةُ القُدُوم	صَالَة الْقُدُومْ
صَالَات الخِطُوط الأَجنَبِيَّة	صَالَاتْ الْخَطُوط الْاَجْنِبِيَة
الخِطُوط الأَجنَبِيَّة	الْخَطوطْ الْاَجْنِبِيَة
الأَمتعَه دِي بِتَعتِى	الْامْتَعْه دِي بِتَعَتَى
دِي حَاجتِي	دِي حَاجْتِي
سَبَع قِطَع	سَبْعْ قَطَّعْ
خَمَس قِطَع	خَمْسْ قَطَّعْ
عَرَبِية أَطفَال	عَرَبِيَّة اَطْفَالْ
اَيوَه القِطعَة دِى بِتَعتِى	اَيوْهْ الْقُطْعَة دَى بِتَعَتَى
اَيوه أَنَا بَدَور عَلى القِطعَة دِي	اَيوْهْ اَنَا بِدوْر عَلَى القَطْعَة دِي
مَكَانُ سَيَّارَاتِ الأُجرَةِ لَو سَمَحت	مَكَان سَيَارَات الْاَجْرَة لو سَمَحَتْ
سّيَّارَاتُ الأُجرَة	سَيَارَات الْاَجْرَة
سّيَّارَةُ الأُجرَة	سَيَارَة الْاَجْرَة
فِينِ الطَرِيءِ لِفُندُء الَمَطَار	فِينْ الطَّرِيءْ لِفْنْدِءْ الْمَطَار
أَأرَب فُندُء	اارَبْ فِنْدَءْ
صَالَة	صَالَة
صَالَات	صَالَاتْ
رِحلَة	رَحَلَة
حَجَات	حَجَاتْ
كَرتَ الصُّعُود	كَرْتْ الصَّعودْ
بَدَور عَلى مُجَمَع أَسوَاء	بِدُوْر عَلَى مَجْمَع اَسْوَاء
أَنَا بَدَور عَلى	اَنَا بِدور عَلَى
عَايِز مُسَعدَه	عَايْزْ مَسْعَدْه
أَنَا عَايِز مُسَّعدِتَك	اَنَا عَايِزْ مَسْعَدْتَكْ
عَايِز تَكسِي	عَايْزْ تَكْسِي
تِئدَر تِسعِفِني	تِيدَرْ تَسْعِفْنِي
عَايِز سَيَارَة أُجرَه	عَايِزْ سَيَارَة اِجْرَه
عَايِز مَوقِع سَيَارَات أُجرَه	عَايِزْ مَوْقَعْ سَيَارَات اَجْرَهْ
إِيه أَأرَب مُستَشفَى	اَيْه اارَبْ مُسْتَشَفَى
أَنَا بَدَور عَلى شَارِع	اَنَا بِدوْر عَلَى شَارَع
بَدَوَر عَلى أَأرَب مَركَز صِحِي	بِدُوْر عَلَى اَاْرَب مَرْكِزْ صَحِي
عَايِز عِلِاج	عَايِزْ عَلَاج
عَايِز الشُرطَة	عَايِزْ الشَّرْطَة
أَنَا عَايِز الشُرطَة	اَنَا عَايِز الشَرْطَة
عَايِز لِّيمُوزِين	عَايِزْ لِيْمُوزِين
أَنَا عَايِز مُسَعدَه	اَنَا عَايِزْ مْسْعَدْه
عَايِز تَكسِي	عَايْزْ تَكْسِي
كَم المَسَافَه مِن الرِياض لِمَكَه	كَمْ الْمَسَافِه مِنْ الرِيَاضْ لِمْكَه
تَاكسِي كِبِير لَو سَمِحت	تَاكْسِي كْبِير لو سَمَحْتْ
عَايز مُوَاصلَات	عَايْزْ مُوَاصْلَاتْ
عَايز أَعرَف حَرَكِة السِّير	عَايْزْ اَعْرَف حَرَكَة الْسِيْر
هُو فِيه زَحمَة	هُو فِيهْ زَحْمَة
السِّاعِة كَام	الْسَاعَةْ كَامْ
كَم سِعرَ صَرف	كم سَعْرْ صَرْفْ
العِنوَان إِيه	الْعَنوان اَيْهْ
العِنوَان إِيه	الْعَنوَانْ اَيَّهْ
مُمكِن تِدِّينِي العِنوَان	مُمْكِنْ تْدِينِي الْعُنوَان
إِيه أَأرَب طَرِيء لِ	اَيْهْ اارَبْ طَرِيءْ لْ
مُمكِن أَتَّصِل	مُمْكِنْ اَتْصَلْ
إِزَّاي أَتَّصِل	اَزَاي اِتْصَلْ
إِيه هُوَا مُفتَاح الدَوله	اَيْهْ هُوَا مَفْتَاحْ الدُّوله
إِيه هِوَّا مُفتَاح المَدِينَه	اَيْهْ هُوَا مَفْتَاحْ الْمَدِينه
الجَوّ عَامِل إِيه فِي مَكة	الجَو عَامِل اَيْه فِي مَكَّة
الجَوّ عَامِل إِيه فِي الرِّيَاض	الْجَوْ عَامِل اَيْه فِي الرِيَّاضْ
الجَوّ عِامِل إِيه فِي	الجَوّ عَامِل اَيْه في
المَسَافَة كَام لِحَد	الْمَسَافَة كَام لِحَدْ
دَرَجَة الحَرَارَة كَام	دَرْجَة الْحَرارَة كَام
أَأرَبُ صَيدَلِيَّة لَو سَمَحت	ااْرَبْ صَيْدَلِيَة لُو سَمَحْتْ
الشَمس بِتِطلَع إِمتَه	الشمْسْ بِتْطَلَعْ اِمْتَه
الشَمس بِتُغرُب إِمتَه	الشَّمْسْ بِتَغْرَبْ اِمْتَهْ
الرِّيَال	الرِيَالْ
الدُّولَار	الْدُّولَار
الجِنِيه	الْجَنِيه
اللَّيرَة	الْلِيرَة
الدِّرهَم	الدَّرْهُمْ
رِيَال	رِيَالْ
دُولَار	دولَارْ
جِنَيه	جَنيهْ
لِيرَه	لِيْرَهْ
دِرهَم	درهَم
تَاكسِي	تَاكْسِي
شَارِع	شَارِعْ
طَرِيء	طَرِيءْ
مَسَافَة	مَسَافَة
عَايِز مَطعَم	عَايْزْ مَطْعَمْ
فِين مُجَمَع المَطَاعِم	فِينْ مَجْمَع الْمَطَاعُمْ
إيه هُو أَأرَب مَطعَم	اَيْهْ هُو اَارَب مَطْعَمْ
عَايِز اَستَعلم عَن بُضَاعَه	عَايِزْ اِسْتَعْلِمْ عِنْ بْضَاعَه
القِطعَه دِي بكَام	الْقَطْعُه دِي بِكَام
دِي بكَام	دِي بِكَام
كَم تَمَن دِي	كمْ تَمْنْ دِي
بكَام دِي	بِكَام دِي
كَم تَمَن دَا	كمْ تَمْنْ دَا
بِكَام القِطعَه دِي	بِكَام الْقَطْعَه دِي
عَايِز أَعرَف تَكَالِيف	عَايِز اَعْرَف تَكَالِيفْ
عَايِز أَشُوف الفَتُورَه	عَايِزْ اَشوف الْفَتُوره
عَايِز أَتأَكِد مِن صِحَة البَيَنَات	عَايِز اَتَاكِدْ مِنْ صَحَّة الْبِينَات
عَايِز أَشتَرِي سِلعَه	عَايِزْ اِشْتِرِي سِلْعَه
عَايِز أَعرَف إِنتِهَاء صَلَاحِية السِّلعَه	عَايِزْ اَعْرَفْ اِنْتِهَاءْ صَلَاحِيَة السّلْعه
عَايِز أَعرَف تَّمَن السِّلعَه دِي	عَايِزْ اَعْرَف تَمْنْ الْسِّلْعَه دِي
عَايِز أَعرَف مُوَاصَفَات السِلعَه دِي	عَايِزْ اَعْرَفْ مَوَاصَفَاتْ الْسّلْعَهْ دِي
الصِوت مُش وَاضِح	الصوت مِشْ وَاضِح
مُش سَمعَك	مِشْ سِمْعَكْ
مُش عَارِف أَسمَع صُوتَك	مُشْ عَارِفْ اَسْمَعْ صُوتَكْ
صُوتَك وَاطي	صُوْتِكْ وَاطِي
إِيه هِيَّا أَوءَات العَمَل	اَيْه هِيَا اوْءَاتْ الْعَمَل
الشُّغل بِيِبدَأ إِمتَه	الشَّغْلْ بِيبْدَا اِمْتَه
الشُغل بِيِخلَص إِمتَه	الشغِلْ بِيْخْلِصْ اَمْتَهُ
المَحَل بِيِفتَح إِمتَه	الْمَحَلْ بِيفْتَحْ اَمْتَهُ
المَحَل بِيِئفِل إِمتَه	الْمَحَلْ بِييْفِلْ اِمْتَه
دَه مُش صَح	دَه مِشْ صَحْ
عَايِز سَيَّارَات الأُجرَة	عَايِزْ سَيَارَاتْ الْاَجْرَة
فِين المَحَل اِللِي بِيِبِيع الأُمَاش	فِينْ الْمَحَل اللِي بِيْبِيعْ الْاَمَاشْ
فِين مَحَلَّات البِيع بِالجُمَلة	فِينْ مَحَلَاتْ الْبِيعْ بِالجُمْلَة
عَايِز أَعرِف عِنوَان	عَايِزْ اَعْرَفْ عَنْوَانْ
فِين مَوقِع الشِّركَة الرَئِيِسِي	فِينْ مَوْقْعْ الشَّرْكَة الْرِييْسِي
هُو فِيه مَرَاكِز خَدَمَات دَاخِل السُوء	هُو فِيهْ مَرَاكِزْ خَدْمَاتْ دَاخِلْ السُّوءْ
فِين أَأرَب بَنك	فِينْ اارِب بِنْكَ
مَحَلَّاتُ الأَطفَال	مَحَلَاتْ الْاَطْفَال
إِزَّاَي تِّئدَرُوا تسَعدُونِي	اَزَاي تِيْدْرُوا تَسْعُدونِي
عَندِي حَالَة طَوَارِئ	عَنْدِي حَالَة طَوَارِي
إِيه هِيَّا أَوءَات العَمَل	اَيْه هِيَا اُوءَاتْ الْعَمَل
بِتِشتَغَلو يَوم الخَمِيس	بِتْشْتْغْلُو يومْ الْخَمِيسْ
فِين الحَمامَات	فِينْ الْحَمَامَاتْ
فِين الحَمامَات	فِينْ الْحَمَامَاتْ
مُمكِن تِئولِي عَلى مَكَان الحَمامَات	مُمْكِنْ تِيولِي عَلَى مَكَان الْحَمَامَاتْ
هُو فِيه حَمامَات أُرّيِبَه	هُو فِيهْ حَمَامَاتْ اَرِيبْهْ
إِيه أَأرَب حَمامَات	اَيْهْ اَاْرَبْ حَمَامَاتْ
غَالِي	غَالِي
غَالِيَة	غَالِيَة
رِخِيص	رَخِيصْ
رِخِيصَة	رَخِيصَة
غَالِيَة أَوِي	غَالِيَة اَوِيْ
الهِدُوم	الْهَدوم
الحِلاَئَة	الْحْلَايَة
الهِدُوم النِّسَائِيَّة	الْهَدُومْ الْنِسَايِيَّة
الهِدُوم الرِجَالية	الْهَدوم الْرَّجَالِيَة
مَحَل	مَحَلْ
مَركز	مَرْكَزْ
خَدَمَات	خَدَمَاتْ
سِعر	سعْر
السَّبت	السَبْتْ
الحَد	الحَدْ
اللِّتنَين	الْلِتْنِينْ
التَلَات	الْتَّلَاتْ
الَاربَع	الْاَرْبَعْ
الخَمِيس	الْخَمِيسْ
الجُمعَه	الْجَمْعه
أَيَّام الأُسبُوع	اَيَامْ الْاَسْبُوعْ
نِهَايَةُ الأُسبُوع	نِهَايَة الاِسْبُوعْ
أجَازَة الاسبُوع	اَجَازَة الاَسْبُوعْ
الخَمِيس وَ الجُمعَه	الخَمِيسْ وْ الْجَمْعه
النَهَاردَه	الْنَّهَارْدْهْ
اِمبَارِح	امْبَارَح
بَعد إِبرِيل	بَعَدْ اِبْرِيلْ
بَعد أَغُسطُس	بَعَدْ اَغْسَطَسْ
بَعد أَكتُوبَر	بَعَدْ اَكْتُوبِرْ
بَعد إِسبُوع	بَعَدْ اَسْبُوعْ
بَعد الأَجَازِه	بَعَدْ الْاَجَازْه
بَعد التَلَات	بَعَدْ التَّلَاتْ
بَعد الخَّرِيف	بَعَدْ الخَرِيفْ
بَعد الدِّرَاسّة	بَعَدْ الدِّرَاسَة
بَعد الرَبِيع	بَعَدْ الرَّبِيعْ
بَعد السَبِت	بَعَدْ السَّبْتْ
بَعد الشَبط	بَعَدْ الشَّبْطْ
بَعد الشِّتَا	بَعَدْ الْشَّتَا
بَعد العَصر	بَعَدْ الْعَصْرْ
بَعد العَقَارِب	بَعَدْ الْعَقَارِب
بَعد العِيد	بَعَدْ الْعِيْد
بَعد المِربّعَانِيَّه	بَعَدْ الْمَرَبْعَانِيه
بَعد المَغرِب	بَعَدْ الْمَغْرِب
بَعد أَسبُوع	بَعَدْ اَسْبُوعْ
بَعد أَغُسطّس	بَعَدْ اَغْسَطَسْ
بَعد اكتُوبَر	بَعَدْ اَكْتُوبَرْ
بَعد أَيلَول	بَعَدْ اَيْلُول
بَعد إِبِرِيل	بَعَدْ اِبْرِيلْ
بَعد أَجَازِة نِهَايِة الَأسِبوع	بَعَدْ اَجَازَة نِهَايَة الاَسْبُوعْ
بَعد جَمَادِي الَاوَل	بَعَدْ جَمَادِي الاَوَل
بَعد جَمَادِي الَاخِر	بَعَدْ جَمَادِي الْاَخْرْ
بَعد جَمَادِي التَانِي	بَعَدْ جَمَادِي التَانِي
بَعد دِئِيئَه	بَعَدْ دِييِيه
بَعد دِيسَمبِر	بَعَدْ دِيسُمْبَرْ
بَعد زِي الحِجَّه	بَعَدْ زِيْ الْحَجّه
بَعد زِي القِعدَه	بَعَدْ زِيْ الْقَعْدَه
بَعد رَبِيع الَاِخِر	بَعَدْ رَبِيعْ الْاَخْر
بَعد رَبِيع الَأَوَل	بَعَدْ رَبِيعْ الْاَوَلْ
فِي الخَرِيف	فِي الخَرِيف
فِي الَخمِيس	فِي الْخَمِيس
فِي الدِّرَاسَة	فِي الْدِّرَاسَة
فِي الرَّبِيع	فِي الربِيعْ
فِي السَّبت	فِي الْسِبْتْ
فِي الشِّبط	فِي الْشَبْطْ
فِي الشِّتَا	فِي الشَتَا
فِي الشّهر الجَاي	فِي الشَهْرْ الجَاي
فِي الصُبح	فِي الصَّبْح
فِي الصَّيف	فِي الصَّيْفْ
فِي الضُّهر	فِي الضَّهْر
فِي السَنَه دِي	فِي الْسَّنْه دِي
فِي السَنَه الدِّرَاسِيِه	فِي السِّنْه الْدَّرَاسِيه
فِي السَنَه ال جَايه	فِي السَنْه ال جَايَهْ
فِي السَنَة المِيلَادِية	فِي الْسِّنَة الْمِيلَادِيَة
فِي السَنَّة الهِجرِيَة	فِي الْسِّنَة الْهَجْرِيَة
فِي العَصر	فِي الْعَصْرْ
فِي العِيد	فِي الْعِيْدْ
فِي اللّيل	فِي الْلِيْلْ
فِي المِربِعَانِيَّه	فِي الْمُرَبْعَانِيهْ
فِي اللّيل	فِي الْلِيْلْ
فِي المَغرِب	فِي الْمَغْرِب
فِي النّهَار	فِي الْنَّهَارْ
فِي الوَسم	فِي الوَسْمْ
فِي أَغُسطَس	فِي اَغْسَطَسْ
فِي أَكتُوبَر	فِي اَكْتُوبِرْ
فِي أَجَازَة آخِر الَأسبُوع	فِي اَجَازَة اَخْرِ الْاِسْبُوعْ
فِي ثَانِيَة	فِي ثَانِيَة
فِي جَمَادِي الَأوَل	فِي جَمَادِي الاَوَّلْ
فِي جَمَادِي الَآخِر	فِي جَمَادِي الْاَخْر
فِي جَمَادِي التَانِيَة	فِي جَمَادِي الْتَانِيَة
فِي دِيسَمبِر	فِي دِيسُمْبَرْ
فِي زِي الحِجَّة	فِي زِي الحَجَّة
فِي زِي القِعدَة	فِي زِيْ الْقَعَدَة
فِي رَبِيع الَآخِر	فِي رَبِيعْ الْاَخْر
فِي رَبِيع الَأَوَل	فِي رَبِيعْ الْاَوَّل
فِي رَبِيع التَانِي	فِي رَبِيعْ الْتَّانِي
فِي رَجَب	فِي رَجَبْ
فِي شَهر	فِي شَهَرْ
فِي سَاعَة	فِي سَاعَةْ
فِي سِبتَمبِر	فِي سِبْتَمْبَرْ
فِي سَنَة	فِي سَنَة
فِي سُهَيل	فِي سَهِيلْ
فِي شُبَاط	فِي شَبَاطْ
فِي شَعبَان	فِي شَعْبَانْ
أَبلَ الَأجَازَة	اَبَلْ الْاَجَازَة
أَبلَ التَلَات	اَبَّلْ الْتَّلَاتْ
أَبلَ الخَرِيف	اَبَلْ الْخَرِيفْ
أَبلَ الخَمِيس	اَبَلْ الْخَمِيس
أَبلَ الدِّرَاسَة	اَبَلْ الْدِّرَاسَة
أَبلَ الرَّبِيع	اَبَلْ الرَّبِيعْ
أَبلَ السَّبت	اَبَلْ السَّبْتْ
أَبلَ الشَّبط	اَبَلْ الشَبْطْ
أَبلَ الشِّتَا	اَبَّلْ الشَّتَا
أَبلَ الشّهر ال جَاي	اَبَلْ الشَّهْرْ ال جَاي
أَبلَ الصُبح	اَبَلْ الصَّبْحْ
أَبلَ الصِيف	اَبْلْ الصّيْفْ
أَبلَ الضُهّر	اَبَلْ الضَّهْر
أَبلَ السَنَة الدِّرَاسِية	اَبَلْ السِّنَة الْدِّرَاسِيَة
أَبلَ السَنَة الِّجَيَة	اَبَلْ السِّنَة الْجَيَّة
أَبلَ السَنَة المِيِلَادِية	اَبَلْ الْسِّنَة الْمِيلَادِيَّة
أَبلَ السَنَة الهِجرِية	اَبَلْ السِّنَة الْهَجْرِيَة
أَبلَ العَصّر	اَبَلْ الْعَصّرْ
أَبلَ العِيد	اَبَّلْ الْعِيْد
أَبلَ الِليِل	اَبَلْ الْلِيلْ
أَبلَ المِربعَانِّية	اَبَلْ الْمَرَبْعَانِيَّة
أَبلَ اللِيل	اَبَّلْ الْلِيلْ
أَبلَ المَغرِب	اَبَلْ الْمَغْرِب
أَبلَ النِهَار	اَبَلْ النّهَارْ
أَبلَ الوَسِم	اَبْلْ الوَسْمْ
أَبلَ أَسبُوع	اَبَّلْ اِسْبُوعْ
أَبلَ أَغُسطُس	اَبَلْ اَغْسْطِسْ
أَبلَ أَكتُوبَر	اَبْلْ اِكْتُوبِرْ
أَبلَ امّبَارِح	اَبَلْ امْبَارَح
أَبلَ إِبرِيل	اَبَّلْ اِبْرِيلْ
أَبلَ أَجَازَة الجُمعَه	اَبَّلْ اَجَازَة الْجُمْعُه
مِن ثَانِيَة	مِنْ ثَانِيَة
أَبلَ جَمَاد الَأوَل	اَبَلْ جَمَاد الْاَوَل
أَبلَ جَمَادِ الَآخِر	اَبَلْ جَمَاد الْاَخْر
أَبلَ جَمَادِ التَانِي	اَبَلْ جَمَاد التَّانِي
مِن دِئِيئَه	مِنْ دِييِيهْ
أَبلَ دِيّسَمبِر	اَبَلْ دِيسَمْبِرْ
أَبلَ زِي الحِجَة	اَبَلْ زِيْ الْحَجّة
أَبلَ زِي القِعدَه	اَبْلْ زِيْ الْقَعْدَه
أَبلَ رَبِيع الَأوَل	اَبَلْ رَبِيعْ الْاَوَل
أَبلَ رَبِيع الَآخِر	اَبَلْ رَبِيعْ الْاَخْر
أَبلَ رَجَب	اَبَّلْ رَجْبْ
أَبلَ سَاعة	اَبَّلْ سَاعَةْ
أَبلَ سِبتَمبِر	اَبَّلْ سِبْتَمْبَرْ
أَبلَ سَنَة	اَبَّلْ سَنة
بَعد رَبِيع التَانِي	بَعَدْ رَبِيعْ التَّانِي
بَعد رَجَب	بَعَدْ رَجْبْ
بَعد رَمَضَان	بَعَدْ رَمْضَانْ
بَعد سَاعَة	بَعَدْ سَاعَةْ
بَعد سِبتَمبِر	بعدْ سِبْتَمْبَرْ
بَعد سَنَه	بَعَدْ سَنْهُ
بَعد سُهَيل	بَعَدْ سَهِيلْ
بَعد شُبَاط	بَعَدْ شْبَاطْ
بَعد شَعبَان	بَعَدْ شَعْبَانْ
بَعد شَهَر	بَعَدْ شَهْرْ
بَعد صَفَر	بَعَدْ صَفْرْ
بَعد سَنَه	بَعَدْ سَنْه
بَعد عَقد	بَعَدْ عَقْدْ
بَعد عِيد الحَج	بَعَدْ عَيْدْ الحَجّ
بَعد عِيد الفِطر	بَعَدْ عَيْدْ الْفَطْرْ
بَعد بُكرَه	بَعَدْ بِكْرَهْ
بَعد مَارِس	بَعَدْ مَارِسْ
بَعد مَايُو	بَعَدْ مَايُو
بَعد مُحَرَم	بَعَدْ مَحْرَمْ
بَعد نُوفَمّبِر	بَعَدْ نوفَمْبَرْ
بُكّرَه	بِكْرَه
فِي اكتُوبَر	فِي اَكْتُوبَرْ
فِي الأسبُوعِ الجَاي	فِي الاَسْبُوع الْجَاي
فِي الأَجَازَة	فِي الْاَجَازَة
فِي شَهَر	فِي شَهَرْ
فِي صَفَر	فِي صَفَرْ
فِي سَنَة أَلف وَاربَعمِيِّة وتَلَاتَ وتَلاتِين هِجرِي	فِي سِنَّة اَلْف وَارْبَعْمِيَّة وَتْلَاتْ وَتْلَاتِينْ هَجْرِي
فِي سَنَة أَلفين وَاتنَاعَشَر مِيلَادِي	فِي سِنَّة الْفِينْ وَاتْنَاعَشْر مِيْلَادِي
فِي عِيد الحَج	فِي عِيْدْ الحَجْ
فِي عِيد الفِطر	فِي عِيدْ الْفَطْرْ
فِي فِبرَايِر	فِي فِبْرَايِر
فِي كَانُون الَأوَّل	فِي كَانُون الْاَوَل
فِي كَانُون التَانِي	فِي كَانُون الْتَّانِي
فِي مَارِس	فِي مَارِسْ
فِي مَايُو	فِي مَايُو
فِي مُحَرَّم	فِي مَحْرَمْ
فِي نُوفَمبِر	فِي نُوفَمْبَرْ
فِي نِيسَان	فِي نِيسَانْ
فِي الأَسبُوع دَه	فِي الْاَسْبُوعْ دَهْ
فِي الشّهر دَه	فِي الشَّهْر دَهْ
فِي يُولِيُه	فِي يُولِيهْ
فِي يَوم	فِي يَومْ
فِي يُونِيَه	فِي يُونِيهْ
أَبلَ أَكتُوبَر	اَبَّلْ اَكْتُوبَرْ
أَبلَ الحَد	اَبَلْ الحَدّ
أَبلَ الأَربَع	اَبَلْ الْاَرْبَعْ
أَبلَ الأَسبُوع الجَاي	اَبَلْ الْاِسْبُوعْ الْجَاي
أَبلَ اللِّتنِين	اَبَّلْ الْلِتْنِين
أَبلَ سُهَيل	اَبَلْ سَهِيلْ
أَبلَ شِبَاط	اَبَّلْ شْبَاطْ
أَبلَ شَعبَان	اَبَّلْ شَعْبَانْ
أَبلَ شَهر	اَبَلْ شَهْرْ
أَبلَ شَوَّال	اَبْلْ شُوَالْ
أَبلَ صَفَر	اَبْلْ صَفْرْ
أَبلَ سَنَة	اَبْلْ سَنة
أَبلَ سَنَة أَلف وَاربَعمِيِّة وتَلَاتَ وتَلاتِين هِجرِي	اَبَلْ سِنَّة اَلْف وَارْبَعْمِيَّة وَتْلَاتْ وَتَلَاتِيْن هَجْرِي
أَبلَ سَنَة أَلفين وَاتنَاعَشَر مِيِلَادِي	اَبَلْ سِنَّة الْفِينْ وَاتْنَاعَشْر مِيْلَادِي
أَبلَ الحِج	اَبَّلْ الحَجّ
أَبلَ عِيد الفِطر	اَبْلْ عَيْدْ الْفَطْرْ
أَبلَ فِبرَايِر	اَبَّلْ فِبْرَايِرْ
أَبلَ مَارِس	اَبَلْ مَارِسْ
أَبلَ مَايُو	اَبَلْ مَايُو
أَبلَ مًحَرَم	اَبَلْ مَحْرَمْ
أَبلَ الَأسِبُوع دَه	اَبَّلْ الْاِسْبُوعْ دَه
أَبلَ الشّهر دَه	اَبْلْ الشَّهْرْ دَهْ
أَبلَ يُولِيُه	اَبْلْ يولِيهْ
أَبلَ يِوم	اَبَلْ يومْ
أَبلَ يُونّيُه	اَبْلْ يونِيهْ
الَأسبُوع دَه	الْاِسْبُوع دَه
الشَهر دَه	الشَّهْرْ دَهْ
السَنَا دِي	الْسّنَا دِي
الوَئت دَه	الويتْ دَهْ
الرِّيَال	الرِيَال
الدُّولَار	الدُّولَار
الجِنِيه	الْجَنِيه
اللِّيرَه	اللِيْرَهْ
الدَّرَاهِم	الدَّرَاهُم
رِيَال	رِيَالْ
دُولَار	دولَارْ
جِنِيه	جَنِيه
لِيرَه	لِيرَهْ
دِرهَم	دَرْهَمْ
رِيَالَات	رِيَالَاتْ
دُولَارَات	دولارَاتْ
جُنَيهَات	جَنِيهَاتْ
لِيرَات	لِيرَاتْ
دَرَاهِم	دْرَاهُم
رِيَال	رِيَالْ
دُولَار	دولَارْ
جِنِيه	جَنيه
لِيرَة	لِيْرَة
دِرهَم	دَرْهَمْ
رِيَال	رِيَال
دُولَار	دولَار
جِنِيه	جَنيه
لِيرَه	لِيرَهْ
دِرهَم	دَرْهَمْ
هَلَلَه	هَلْلَهْ
فِلس	فَلْسْ
بِنس	بِنَسْ
سِنت	سَنْتَ
رِيَال	رِيَالْ
رِيَال	رِيَالْ
رِيَال	رِيَالْ
رِيَالَات	رِيَالَاتْ
رِيَالِين	رِيَالِين
رِيَالِين	رِيَالِين
هَلَلَات	هَلْلَاتْ
هَلَلَة	هَلَلَة
هَلَلَة	هَلَلَة
هَلَلَة	هَلَلَة
هَلَلَتَين	هَلْلَتِينْ
هَلَلَتَين	هَلْلَتِينْ
سِنت	سَنْت
أَبُوظَبِي	اَبوظْبِي
أَتلَانتَا	اَتْلَانْتَا
أَثِينَا	اَثِينَا
أَحمَد أَبَاد	اَحْمَدْ اَبَادْ
إِدَنبَرَه	اَدْنْبَرَه
أَدِيس أَبَابَا	اَدِيسْ اَبَابَا
أَزمِير	اَزْمِيرْ
إِسبرِنق فِيلد	اَسْبَرْنْقْ فِيلْدْ
أُستُكهُولم	اَسْتَكْهُولْمْ
إِسطَنبُول	اِسْطَنْبُولْ
إِسلام أَبَاد	اَسْلَامْ اَبَادْ
أَسوَان	اَسْوَانْ
أَكرَا	اَكْرَا
الإسكَندَريَّة	الْاِسْكُنْدَرِيَّة
أَلبَانِيَا	الْبَانِيَا
البَصرَة	الْبَصْرَة
الجَزَائِر	الْجَزَايِرْ
الخَرطوم	الْخَرْطُوم
الدَّارُ البَيضَاء	الْدَارْ الْبِيضَاء
الدِوحَة	الدُّوْحَة
الرِّبَاط	الرَّبَاطْ
القَاهِرَة	القَاهْرَة
القُدس	القُدْس
الكِوَيت	الْكُويتْ
المَنَامَة	الْمَنَامَة
المَوصِل	الْمُوْصِلْ
أُمُّ دَرمَان	ام دَرْمَانْ
أَمِستَردَام	اَمْسَتَرْدَام
أنتاناناريفو	اِنْتِانَانَارِيفُو
إِندِيَانَا بُولِس	اِنْدِيَانَا بُولِسْ
أَنقَرَة	اَنْقَرَة
أُوتَاوَا	اوْتَاوَا
أُورلاندُو	اورْلَانْدُو
أُوستِن	اوسْتِنْ
أُوسلُو	اَوسْلُو
أُوكلاهُومَا	اَوْكْلَاهُومَا
بَاتُون رُوج	بَاتُون رُوجْ
بَارِيس	بَارِيسْ
بَانجلُور	بانجلور
بَاندُونج	بَانْدُونَج
بَانكُوك	بَانْكُوكْ
بَرَازِيلِيَا	بْرَازِيلِيَا
بَرشَلُونَة	بَرشْلُونَة
بِرلِين	بِرْلِين
بِرمِنجهَام	بِرَمْنْجْهَام
بُوسطُن	بوسْطِنْ
بُومبَاي	بومْبَاي
بُون	بُونْ
بِيتسُورنِي	بيتْسُورْنِي
بِيرث	بِيرث
بَيرُوت	بِيْرُوتْ
بِيشَاوَر	بِيشَاوِر
بِيغَان	بِيغَان
بِينَانج	بِينَانَجْ
بِيُونِس اَيرِس	بيونس ايرس
تَالاهَاسِي	تَالْاَهَاسِي
تَايبِيه	تَايْبِيهْ
تُوبِيكا	تُوبِيكَا
تُورُنتُو	تُورِنْتُو
تُونِس	تُونِسْ
جَاكَرتَا	جَاكْرْتَا
جلاسكُو	جَلَاسْكُو
جُوهَانسبِرج	جوهَانْسِبْرَجْ
جِيبُوتِي	جِيبُوتِي
حَلَب	حَلَبْ
دَارُ السَّلام	دَارْ السَّلَامْ
دَاروِين	دَارويْنْ
دَاكَار	دَاكَارْ
دَالَاس	دَالَاسْ
دَبلِن	دِبْلِنْ
دُبَي	دْبِيْ
دَكَّا	دَكَا
دِمَشق	دِمْشَقْ
دِي تَروِيت	دِي تَرويْتْ
دِيرهَام	دِيْرْهَامْ
دِينِفَر	دِيْنْفِرْ
رُومَا	رُومَا
رِيكَامُوند	رِيكَامونْد
رِيُو دِي جَانِيرُو	رِيوْ دِي جَانِيرُو
زِيُورِخ	زِيورَخ
سَان سِلفَادُور	سَانْ سِلْفَادُور
سَانتِيَاغُو	سَانْتِيَاغُو
سَاند يِيِجُو	سَانْدْ يِيجُو
سَاو بَاولُو	سَاوْ باوْلو
سَرَابَايَا	سَرَابَايَا
سَنغَافُورَة	سَنْغَافورَة
سَيؤُول	سَيوولْ
سِيدنِي	سِيدْنِي
شَنغَهَاي	شَنْغْهَايْ
شُونجُونج	شونْجُونَج
فِيَنَّا	فِينَا
كَابُول	كَابول
كَاردِيف	كَارْدِيفْ
كَازَبلَانكَا	كَازْبْلَانْكَا
كَانبِيرا	كَانْبِيرَا
كَرَاتشِي	كراتْشِي
كَرَاكَاس	كرَاكَاس
كوَالَالَمبُور	كوالْالْمْبُورْ
كوَانتَان	كوانْتَان
كُوبِنهَاجِن	كوبْنْهَاجِن
كُولُمبُس	كولْمْبْس
كُولُومبُو	كولومْبُو
كُولُومبِيَا	كولومْبِيَا
كِيب تَاون	كِيْبْ تَاوِنْ
كِيتُو	كِيتُو
لاس فِيجَاس	لَاسْ فِيجَاسْ
لاغُوس	لاغوسْ
لانسِنق	لَانْسْنْقْ
لاهُور	لاهورْ
لَشبُونَة	لَشْبُونَة
لَندَن	لَنْدِنْ
لُوس أَنجلُوس	لُوسْ اِنْجِلوسْ
لِيمَا	لِيمَا
ليُون	لِيُونْ
مَاربِيَّا	مَارِبِيَا
مَارسِيلِيَا	مَارْسِيلِيَا
مَانَاجوا	مَانَاجُوا
مَانِيلا	مَانِيلَا
مِدرَاس	مِدْرَاسْ
مَدرِيد	مَدْرِيدْ
مَرَّاكِش	مَرَاكِشْ
مَسقَط	مَسْقَطْ
مَقدِيشُو	مَقْدِيشُو
مِكسِيكُو سِتِي	مَكْسِيكُو سَتِي
مَلبُورن	مَلْبُورِنْ
مُوسكُو	مُوسْكُو
مُونتِريَال	مُونْتِرِيَال
مِيلان	مِيلَانْ
ميُونِخ	مِيونْخْ
نَابُولي	نَابُولِي
نَانت	نَانْتْ
نَوَاكشُوط	نواكْشُوطْ
نَيرُوبِي	نِيرُوبِي
نِيس	نِيسْ
نيُودِلهِي	نِيودِلْهِي
بِرمِنجهَام	بِرْمَنْجِهَام
برِيتُورِي	بَرِيتُورِي
بَغدَاد	بَغْدَادْ
بِكِّين	بِكِيْن
بِلغرَاد	بِلْغَرَادْ
بَلفَاست	بِلفَاسِتْ
بلُومِنقتُون	بِلُومِنْقِتُونْ
بِنغَازِي	بِنْغَازِي
بُوجُوتَا	بِوجُوتَا
بُوخَارِست	بوخارْسْتْ
بُودَابِست	بودَابْسْتْ
بُورتلاند	بورْتْلَانِد
بُور سُودَان	بورْ سُودَان
شِيكَاغُو	شِيكَاغُو
صَنعَاء	صَنْعَاءَ
صُوفِيَا	صُوفِيَا
طَرَابلُس	طَرَابْلِسْ
طَهرَان	طَهَرَانْ
طُوكيُو	طُوكِيوْ
عَبدَان	عَبْدَانْ
عَدَن	عَدَنْ
عَمَّان	عَمَان
غَزَّه	غَزْه
فَانكُوفَر	فَانْكُوفِرْ
فرَانكفُورت	فرانْكفورتْ
نيُوكَاسِل	نِيوكَاسِل
نيُويُورك	نِيويورَكْ
هَاتفُورد	هَاتْفُورِدْ
هَارسبِيرق	هَارْسْبِيرَقْ
هَافَانَا برَاغ	هَافَانَا بْرَاغ
هَانُوي	هَانُوي
هِلسِنكِي	هَلْسِنْكِي
هُونج كُونج	هونَج كونَجْ
وَارسُو	وَارْسُو
وَاشُنطُن دِي سِي	وَاشْنْطُنْ دِي سِيْ
وُلِينجتُون	وَلِيْنْجْتونْ
وَهرَان	وَهَرَانْ
وَاحِد	وَاحِدْ
اِتنِين	اِتْنِينْ
اِتنِين	اِتْنِين
تَلَاتَة	تَلَاتَة
أَربَعَة	اَرْبَعَة
خَمسَة	خَمْسَة
سِتَّة	سَتة
سَبعَة	سَبْعَة
تَمَانيَة	تَمَانِيَة
تِسعَة	تَسْعَةَ
عَشَرَة	عَشْرَة
حِّدَاشر	حَدَاشِر
اِتنَاشَّر	اَتْنَاشِر
تَالَتَاشَر	تَالْتَاشِر
أَربَعتَاشَر	اَرْبْعْتَاشِر
خَمَستَاشَر	خَمْسَتَاشِر
سِتَاشَر	سْتَاشِر
سَبَعتَاشَر	سَبْعْتَاشِر
تَمَنتَاشَر	تِمْنْتَاشِر
تِسعتَاشَر	تِسْعَتَاشِر
عِشرِين	عَشْرِينْ
وَاحِد وَعِشرِين	وَاحِد وَعِشْرِينْ
اِتنِين وِعِشرِين	اِتْنِين وَعَشْرِينْ
تَلَاته وِعِشرِين	تَلْاتِه وَعِشْرِينْ
أَربَعَة وِعِشرِين	اَرْبَعَة وَعِشْرِينْ
خَمسَة وِعِشرِين	خَمْسَة وَعِشْرِينْ
سِتة وِعِشرِين	سِتَّة وَعِشْرِينْ
سَبعَة وِعِشرِين	سَبْعَة وَعِشْرِينْ
تَمَانية وِ عِشرِين	تَمَانِيَة وْ عِشْرِينْ
تِسعَة وِعِشرِين	تِسْعَةْ وَعِشْرِينْ
تَلَتِين	تَلْتِينْ
وَاحِد وِتَلَتِين	وَاحِد وَتَلْتِينْ
اِتنِين وِتَلَتِين	اِتْنِين وَتَلْتِين
تَلَاتَة وِتَلَتِين	تَلَاتَة وَتَلْتِينْ
أَربَعَة وِتَلَتِين	اَرْبَعَة وَتَلْتِينْ
خَمسَة وِتَلَتِين	خَمْسَة وَتَلْتِينْ
سِتَّة وِتَلَتِين	سِتَّة وْتَلْتِينْ
سَبعَة وِتَلَتِين	سَبْعَة وَتَلْتِينْ
تَمَانيَة وِتَلَتِين	تَمَانِيَة وَتَلْتِين
تِسعَة وِتَلَتِين	تِسْعَة وَتَلْتِينْ
أربِعين	اَرْبْعِينْ
وَاحِد وِأربِعين	وَاحِد وَارْبْعِينْ
اِتنِين وِأربِعين	اِتْنِينْ وَاَرْبْعِينْ
تَلَاتَة وِأربِعين	تَلَاتَة وَارْبَعِينْ
أَربَعَة وِأربِعين	اَرْبَعَة وَاَرْبْعِينْ
خَمسَة وِأربِعين	خَمْسَة وَاَرْبَعِينْ
سِتَّة وِأربِعين	سِتَّة وْاَرْبَعِينْ
سَبعَة وِأربِعين	سَبْعَة وَارْبَعِينْ
تَمَانيَة وِأربِعين	تَمَانِيَة وَاَرْبَعِينْ
تِسعَة وِأربِعين	تِسْعَة وَاَرْبَعِينْ
خَمسِين	خَمْسِينْ
وَاحِد وِخَمسِين	وَاحِد وَخَمْسِينْ
اِتنِين وِخَمسِين	اِتْنِينْ وَخَمْسِينْ
تَلَاتَة وِخَمسِين	تَلْاتَة وَخَمْسِينْ
أَربَعَة وِخَمسِين	اَرْبَعَة وَخَمْسِينْ
خَمسَة وِخَمسِين	خَمْسَة وَخَمْسِينْ
سِتَّة وِخَمسِين	سِتَة وْخَمْسِينْ
سَبعَة وِخَمسِين	سَبْعَة وَخَمْسِين
تَمَانيَة وِخَمسِين	تَمَانِيَة وَخَمْسِينْ
تِسعَة وِخَمسِين	تِسْعَة وَخَمْسِينْ
سِتِّين	سْتِين
وَاحِد وِسِتِين	وَاحْد وَسْتِين
اِتنِين وِسِتِين	اَتْنِين وَسَتِيْن
تَلَاتَة وِسِتِين	تِلْاَتَة وَسْتِيْنْ
أَربَعَة وِسِتِين	اَرْبَعَة وَسْتِينْ
خَمسَة وِسِتِين	خَمْسَة وَسْتِينْ
سِتَّة وِسِتِين	سَتَة وَسْتِينْ
سَبعَة وِسِتِين	سَبْعَة وَسْتِينْ
تَمَانيَة وِسِتِين	تَمَانِيَة وَسْتِينْ
تِسعَة وِسِتِين	تِسْعَة وَسْتِين
سَبعِين	سَبْعِين
وَاحِد وِسَبعِين	وَاحِد وَسْبْعِينْ
اِتنِين وِسَبعِين	اِتْنِيْن وَسَبْعِينْ
تَلَاتَة وِسَبعِين	تَلْاتَة وَسَبْعِينْ
أَربَعَة وِسَبعِين	اَرْبَعَة وَسْبْعِينْ
خَمسَة وِسَبعِين	خَمْسَة وَسَبْعِينْ
سِتَّة وِسَبعِين	سَتَة وَسَبْعِينْ
سَبعَة وِسَبعِين	سَبْعَة وَسْبْعِينْ
تَمَانيَة وِسَبعِين	تَمَانِيَة وَسَبْعِينْ
تِسعَة وِسَبعِين	تِسْعَة وَسَبْعِينْ
تَمَنين	تَمْنِينْ
وَاحِد وِتَمَنين	وَاحِد وَتَمْنِينْ
اِتنِين وِتَمَنين	اِتْنِين وَتَمْنِينْ
تَلَاتَة وِتَمَنين	تَلَاتَة وَتَمْنِين
أَربَعَة وِتَمَنين	اَرْبَعَة وَتَمْنِينْ
خَمسَة وِتَمَنين	خَمْسَة وَتَمْنِين
سِتَّة وِتَمَنين	سَتَّة وَتَمْنِين
سَبعَة وِتَمَنين	سَبْعَة وَتَمْنِين
تَمَانيَة وِتَمَنين	تْمَانِيَة وَتَمْنِين
تِسعَة وِتَمَنين	تِسْعَة وَتَمْنِين
تِسعِين	تَسْعِينْ
وَاحِد وِتِسعِين	وَاحِد وَتْسْعِين
اِتنِين وِتِسعِين	اِتْنِين وَتَسَعِينْ
تَلَاتَة وِتِسعِين	تَلْاتَة وَتَسْعِينْ
أَربَعَة وِتِسعِين	اَرْبَعَة وَتْسْعِينْ
خَمسَة وِتِسعِين	خَمْسَة وَتَسْعِين
سِتَّة وِتِسعِين	سَتَّة وَتَسْعِينْ
سَبعَة وِتِسعِين	سَبْعَة وَتْسْعِينْ
تَمَانيَة وِتِسعِين	تَمَانِيَة وَتَسْعِينْ
تِسعَة وِتِسعِين	تِسْعَة وَتَسْعِينْ
مِية	مِية
ألف	الفَ
اِثنَا عَشَرَ	اِثْنَا عَشَرْ
اِثنَانِ	اَثْنَانْ
اِثنَتَا عَشرَة	اِثْنَتَا عَشْرَة
اِثنَتَانِ	اِثْنَتَانْ
اِثنَتَي عَشرَة	اِثْنِتِي عَشْرَة
اِثنَتَينِ	اِثْنَتِينْ
اِثنَي عَشَرَ	اِثْنِي عَشَرْ
اِثنَينِ	اَثْنِيْنْ
آلَافٍ	اِلَافْ
آلَافِ	الَافْ
أَحَدَ عَشَرَ	اَحَدْ عَشَرْ
أَربَعٌ	اَرْبَعْ
أَربَعُ	اَرْبَعْ
أَربَعَ	اَرْبَعْ
أَربَعٍ	اَرْبَعَ
أَربَعِ	اَرْبَعَ
أَربَعَ عَشرَة	اَرْبَعْ عَشْرَة
أَربَعًا	اَرْبَعَا
أَربَعَةٌ	اَرْبَعَة
أَربَعَةُ	اَرْبَعَة
أَربَعَةً	اَرْبَعَة
أَربَعَةَ	اَرْبَعَة
أَربَعَةٍ	اَرْبَعَة
أَربَعَةِ	اَرْبَعَة
أَربَعَة عَشَرَ	اَرْبَعَة عَشْرْ
أَربعُمِائةٍ	اَرْبْعْمَايَة
أَربَعُمِائةِ	اَرْبْعْمَايَة
أَربَعَمِائةٍ	اَرْبْعْمَايَة
أَربَعَمِائةِ	اَرْبْعْمَايَة
أَربَعِمِائةٍ	اَرْبْعَمَايَة
أَربَعِمِائةِ	اَرْبَعْمَايَة
أَربَعُونَ	اَرْبَعُونْ
أَلفٌ	الفْ
أَلفُ	الْف
أَلفَ	الْف
أَلفٍ	الف
أَلفِ	الْفَ
أَلفًا	الْفا
أَلفا	الفَا
أَلفَانِ	الْفَان
أَلفَي	اَلْفِي
أَلفَينِ	اَلْفِينْ
إِحدَى عَشرَة	اَحْدَى عَشْرَة
تِسعٌ	تَسْعْ
تِسعُ	تَسْعَ
تِسعَ	تَسْعْ
تِسع	تَسْعْ
تِسع	تَسْعْ
تِسعَ عَشرَة	تِسْعْ عَشْرَة
تِسعًا	تِسْعَا
تِسعَةٌ	تَسْعَة
تِسعَةُ	تَسْعَة
تِسعَةً	تَسْعَة
تِسعَةَ	تِسْعَة
تِسعَةٍ	تَسْعَة
تِسعَةِ	تَسْعَة
تِسعَةَ عَشَرَ	تِسْعَة عَشْر
تِسعُمِائةٍ	تَسْعَمَايَة
تِسعُمِائةِ	تَسْعَمَايَة
تِسعَمِائةٍ	تَسْعَمَايَة
تِسعَمِائةِ	تَسْعْمَايَة
تِسعِمِائةٍ	تَسْعَمَايَة
تِسعِمِائةِ	تَسْعَمَايَة
تِسعُونَ	تَسْعُونْ
تِسعِينَ	تَسْعِين
ثَلاثٌ	ثَلَاثْ
ثَلاثُ	ثَلَاثْ
ثَلاثَ	ثَلَاثْ
ثَلاثٍ	ثَلَاثْ
ثَلاثِ	ثَلَاثْ
ثَلاثَ عَشرَة	ثَلَاث عَشْرَة
ثَلاثًا	ثَلَاثَا
ثَلاثَةٌ	ثَلاثَة
ثَلاثَةُ	ثَلاثَة
ثَلاثَةً	ثَلَاثَة
ثَلاثَةَ	ثَلاثَة
ثَلاثَةٍ	ثَلَاثَة
ثَلاثَةِ	ثَلْاثَة
ثَلاثَةَ عَشَرَ	ثَلَاثَة عَشَرَ
ثَلَاثُمِائةٍ	ثَلَاثْمَايَة
ثَلَاثُمِائةِ	ثَلَاثْمَايَة
ثَلَاثَمِائةٍ	ثَلاثْمَايَة
ثَلَاثَمِائةِ	ثَلْاثْمَايَة
ثَلاثِمِائةٍ	ثَلَاثْمَايَة
ثَلاثِمِائةِ	ثَلَاثْمَايَة
ثَلَاثُونَ	ثَلَاثُونْ
ثَلَاثِينَ	ثَلَاثِينْ
ثَمَانٍ	ثَمَان
ثَمَانِمِائةِ	ثَمَانِمَايَة
ثَمَانِمِائةٍ	ثَمَانْمَايَة
ثَمَانُونَ	ثَمَانُونْ
ثَمَانِي	ثَمَانِي
ثَمَانِيَ عَشرَة	ثَمَانِي عَشْرَة
ثَمَانِيًا	ثَمَانِيَا
ثَمَانِيَةٌ	ثَمَانِيَة
ثَمَانِيَةُ	ثَمَانِيَة
ثَمَانِيَةً	ثَمَانِيَة
ثَمَانِيَةَ	ثَمَّانِيَة
ثَمَانِيَةٍ	ثَمَانِيَة
ثَمَانِيَةِ	ثَمَانِيَة
ثَمَانِيَةَ عَشَرَ	ثَمَانِيَة عَشْرْ
ثَمَانِينَ	ثَمَانِينْ
خَمسٌ	خَمَسْ
خَمسُ	خَمْسْ
خَمسَ	خَمَسْ
خَمسٍ	خَمَّسْ
خَمسِ	خمسْ
خَمسَ عَشرَة	خَمْسْ عَشَرَة
خَمسًا	خَمَسَا
خَمسَةٌ	خَمْسَة
خَمسَةُ	خَمْسَة
خَمسَةً	خَمْسَة
خَمسَةَ	خَمْسَة
خَمسَةٍ	خَمْسَة
خَمسَةِ	خَمْسَة
خَمسَةَ عَشَرَ	خَمْسَة عَشَرْ
خَمسُمَائةٍ	خَمْسْمَايَة
خَمسُمَائةِ	خَمْسْمَايَة
خَمسَمَائةٍ	خَمْسْمَايَة
خَمسَمَائةِ	خَمْسْمَايَة
خَمسِمَائةٍ	خَمْسْمَايَة
خَمسِمَائةِ	خَمْسْمَايَة
خَمسُونَ	خَمْسُونْ
خَمسِينَ	خَمْسِينْ
سَبعٌ	سَبْعْ
سَبعُ	سَبْعْ
سَبعَ	سَبْعْ
سَبعٍ	سَبْعَ
سَبعِ	سَبْعْ
سَبعَ عَشرَة	سَبَّعْ عَشْرَة
سَبعًا	سَبْعَا
سَبعةٌ	سَبْعَة
سَبعَةُ	سَبْعَة
سَبعَةً	سَبْعَة
سَبعَةَ	سَبْعَة
سَبعَةٍ	سَبْعَة
سَبعَةِ	سَبْعَة
سَبعَةَ عَشَرَ	سَبْعَة عَشَرْ
سَبعُمِائةٍ	سَبْعْمَايَة
سَبعُمِائةِ	سَبْعْمَايَة
سَبعَمِائةٍ	سَبْعْمَايَة
سَبعَمِائةِ	سَبْعْمَايَة
سَبعِمِائةٍ	سَبْعْمَايَة
سَبعِمِائةِ	سَبْعْمَايَة
سَبعُونَ	سَبْعُونْ
سَبعِينَ	سَبْعِين
سِتٌّ	ست
سِتًّ	ست
سِتَّ	ست
سِتٍّ	ست
سِتِّ	ست
سِتَّ عَشرَة	سَتْ عَشْرَة
سِتًّ	ست
سِتَّةٌ	سَتة
سِتَّةُ	ستة
سِتَّةً	سَتَة
سِتَّةَ	ستة
سِتَّةٍ	سَتَة
سِتَّةِ	سَتَة
سِتَّةَ عَشَرَ	سَتّة عَشْر
سِتُّمِائةٍ	سْتْمَايَة
سِتُّمِائةِ	سِتْمَايَة
سِتَّمِائةٍ	سْتْمَايَة
سِتَّمِائةِ	سِتْمَايَة
سِتِّمِائةٍ	سَتْمَايَة
سِتِّمِائةِ	سِتْمَايَة
سِتُّونَ	سَتونْ
سِتِّينَ	سَتِين
عَشرٌ	عَشَرْ
عَشرُ	عَشَرَ
عَشرَ	عَشَرْ
عَشرِ	عَشَرْ
عَشرٍ	عَشْرْ
عَشرًا	عَشَرَا
عَشَرَةٌ	عَشَرَة
عَشَرَةَ	عَشْرَة
عَشَرَةً	عَشْرَة
عَشَرَة	عَشَرَة
عَشَرَةٍ	عَشَرَة
عَشَرَةِ	عَشْرَة
عِشرُونَ	عَشْرُونْ
عِشرِينَ	عَشْرِينْ
مِائَةٌ	مَايَة
مِائَةُ	مَايَة
مِائَةً	مَايَةْ
مِائَةَ	مَايَة
مِائَةٍ	مَايَةْ
مِائَةِ	مَايَة
مِائَتَا	مَايْتَا
مِائَتَانِ	مَايْتِانْ
مِائَتَي	مَايْتِي
مِائَتَينِ	مَايْتِين
مَلايِينٍ	مَلَايِين
مَلايينِ	مْلَايِين
مِليَارٌ	مِلْيَارْ
مِليَارُ	مِلْيَار
مِليَارَ	مْلْيَار
مِليَارٍ	مِلْيَار
مِليَارِ	مَلْيَار
مَليِارًا	ملْيَارَا
مِليَارا	مْلْيارَا
مِليَارَاتٍ	مْلْيَارات
مِليِارِاتِ	مْلْيَارَات
مِليَارَانِ	مِلْيَارَان
مِليَارَيَّ	مَلْيَارِي
مِليَارَينِ	مَلْيَارِين
مِليُونٌ	مِلْيونْ
مِليُونُ	مِلْيونْ
مِليُونَ	مَلْيونْ
مِليُونِ	مِلْيونْ
مِليُونٍ	مِلْيونْ
مِليُونًا	مِلْيونا
مِليُونَا	مْلْيونَا
مِليُونَانِ	مْلْيونَان
مِليُونَيّ	مَلْيونِي
مِليُونَينِ	مَلْيونِين
وَاحِدٌ	وَاحِدْ
وَاحِدٍ	وَاحِدْ
وَاحِدًا	وَاحْدَا
وَاحِدَةٌ	وَاحْدَة
وَاحِدَةً	وَاحْدَة
وَاحِدَةٍ	وَاحْدَة
السَّلَامُ	السَلَامْ
السَّلَامُ عَلِيكُم وَرَحمَةُ اللهِ	السَّلَامْ عَلَيْكُمْ وَرْحَمَة الله
تَسمَح	تَسْمَحْ
لَو	لو
اَلله	الْلهْ
لَو تَكَرَّمت	لو تِكْرَمْتْ
اَلله	الله
أَبِي اَلله	اَبِي اِلَله
اَلله لَايهِينِك جِب	اللَه لايْهِينَكْ جِبْ
عِندِك	عَنْدَكْ
اِصبِر	اَصْبَرْ
أَبَحتِرِيك	اَبْحَتِرِيكْ
مِتَى تسَكّرُون	مْتى تَسْكُرُونْ
مِتَى تَفتِحُون	مَتى تَفْتَحُونْ
تقَدّمُون وَجبَة	تَقَدْمُونْ وَجْبَةً
تقَدّمُون وَجبَة عَشَا وغَدَا	تَقَدْمُونْ وَجْبَة عَشَا وَغْدَا
تقَدّمُون وَجبَة	تَقَدْمُونْ وَجْبَة
الصُّوت مُب	الصوْتْ مَبْ
مَا	مَا
مَا أَقدَر	مَا اَقْدَرْ
صُوتِك	صوتَكْ
يَالِيت	يَالِيتْ
يَالِيت	يَالِيتْ
يَالِيت تعِيد عَلَيَّ المَعلُومَات أللِّي	يَالِيتْ تَعِيدْ عَلِي الْمَعْلُومَاتْ الْلِي
أَبغَى أَتكَلَّم مَعَ	اَبْغَى اِتْكَلِمْ مَعْ
مِن هُو المُدِير	مِنْ هُو الْمَدِير
مَا أَدري وِش	مَا اِدْرِي وَشْ
مَا فَهَمت وِش	مَا فَهَمْتْ وَشْ
مَا فَهَمت وِش	مَا فَهَمْتْ وَشْ
مَا	مَا
مَا فَهَمت وِش	مَا فَهَمْتْ وَشْ
مَا فَهَمتِي وِشَ	مَا فَهَمْتِي وَشْ
مَا فَهَمتِي وِشَ	مَا فَهَمْتِي وَشْ
مَا	مَا
فِيه مِكَان لَلِّي ما	فِيهْ مْكَانْ لِلِي مَا
فِيه قِسِم لَلِّي ما	فِيهْ قَسْمْ لِلِي مَا
أَبِي مِكَان غِير	اَبِي مَكَانْ غِيْرْ
وِين مِكَان غِير	وِيْنْ مَكَانْ غِيْرْ
وين مِكَان	وِيْنْ مَكَان
مَعَلِيش أَنَا	مَعْلِيشْ اَنَا
أَعتِذِر أَنَا	اَعْتَذِرْ اَنَا
لَو	لوْ
شُكرًا	شَكْرَا
شُكرًا	شَكْرَا
مَا	مَا
مَا	مَا
مَا	مَا
أنَا	اَنَا
اِسمَح	اَسْمَحْ
اِسمِحِي	اَسْمَحِي
أَنَا أَعتَذِر	اَنَّا اَعْتَذِرْ
وِش أَنوَاع تَتبِيلَة	وَش اَنْوَاعْ تَتْبِيلَة
وِشَ السَّلَطَات أللِّي	وَشْ السُلْطَات الْلِي
وِشَ السَّلَطَات أللِّي	وَش السُلْطَاتْ الْلِي
لَو سَمَحت أَبِي	لو سَمْحْتْ اَبِي
أَبغَى كُوب	اِبْغَى كُوب
هَات القهَوِة	هَاتْ الْقُهوَة
جِيبَي	جِيْبِي
اَلله لَا يهِينِك أَبِي	الله لَا يَهِينَكْ اِبِي
أَبغَى بيَالَة شَاهِي	اِبْغَى بِيَالَة شَاهِي
جَهّزِي لِنَا الشَّاهِي بَعدَ	جِهْزِي لِنَا الشَاهِي بَعَدْ
الله لَا يهِينِك أَبِي الأَكِل	الله لَا يِهِينُكْ اِبْي الاَكُلْ
هَات السَّلَطَات قَبلَ	هَاتْ السُلْطَاتْ قَبَلْ
أَبغَى	اَبْغَى
أَبغَى	اَبْغَى
جِب لِنَا	جَبْ لَنَا
عَطنَا وَقت نِختَار	عَطْنَا وَقْتْ نِخْتَارْ
عَطنَا	عَطَنَا
مَا اختَرت الطَّلَب	مَا اِخْتَرْتْ الطَلْب
مَا قَرَّرت إلى	مَا قَرْرْتْ اِلَى
عَطنَا شوَيَّة وَقت	عَطْنَا شْوََيَّة وَقْتْ
يَبِي لِي شوَيَّة وَقت	يِبِي لِي شْوََيَّة وَقَتْ
وش الأكَلَات المَوجُودَة عِندِكُم	وَشْ الْاِكْلَات الْمَوْجُودَة عَنْدْكُم
وش رَايِك وِش	وَشْ رَايْكْ وَش
شُربَة خُظَار بزِيت	شَرْبَة خَظَارْ بِزِيتْ
عَسَل وجُبِن ومرَبَّى	عَسْلْ وَجْبْنْ وَمْرَبَى
حَلَوِيَّة مَع زِبدَة فُول	حَلوِيَّة مَعْ زِبْدَة فُولْ
وش تِقتِرِح لِنَا	وَشْ تِقْتَرَح لَنَا
إِيش شُوربَةَ	اَيْش شُورَبَة
إِيش طَبَقَ اليُوم	اَيْشْ طَبْقْ الْيوم
دِجَاج	دَجَاجْ
لَحَم مَعَ	لَحَمْ مَعْ
رِزّ	رز
رِزّ	رز
مشَكَّل	مَشْكَلْ
أَكلَات	اَكْلَاتْ
أَحِبَّ الأَكِل	اَحِبّ الْاَكل
صِحِّة	صَحَة
أَبغَى	اَبْغَى
عَطنَا زيَادَة	عَطْنَا زِيَادَة
وِش تَنصَحنَا	وَشْ تَنْصْحْنَا
وِش تَنصَحِينَّا	وَشْ تَنْصَحِينَا
وِش أَحسَن أَكِل	وَشْ اَحْسَنْ اَكَلْ
أَحسَن	اَحْسِنْ
هَات المُقَبِّلات ثُم بَاقِي	هَاتْ الْمُقْبِلَاتْ ثُمْ بَاقِي
عِندكُم بُوفِيه	عَنْدْكُم بُوفِيهْ
وِش يَشمَل البُوفِيه	وش يِشْمِلْ الْبُوفِيهْ
هَل كِلَّ الَأكِل حَلَال	هَلْ كُلْ الْاَكِل حَلَال
وِشَ العَصَايِر أللِّي عِندِكُم	وَش الْعَصَايِر الْلِي عَنْدْكُم
عَصِير	عَصيْرْ
فُول	فَوَّلْ
خُبز صَامُولِي وَخُبز	خَبْز صَامُولِي وَخَبْزْ
أَربَع خُبزَات	اَرْبَعْ خَبْزَاتْ
فُول	فَوَّلْ
عَصِير	عَصيْرْ
عَصِير فَوَاكِهَ	عَصِيرْ فَوَاكِه
عَصِير بُرتُقَال	عَصِيْرْ بَرْتَقَال
ثَلاث	ثَلَاث
مِلعَقِه	مَلْعَقْهُ
صَحَن	صَحْنْ
صَحَن	صَحْنْ
أَنَا	اَنَا
أَنَا	اَنَا
أَبِي	اَبِي
شُربَة	شَرَّبَة
شُربَة	شَرْبَة
شُربَة	شَرْبَة
شُربَة	شَرْبَة
الأَكِل مَا كَان	الْاَكِلْ مَا كَانْ
العَشَاء طَعمُه	الْعَشَاء طَعْمه
أحسَن أَكلِه	اَحْسَنْ اَكْله
هاذِي أَحسَن	هَاذِي اَحْسِنْ
هَالطَّلَب	هَالطَلْب
هالطَّلَب مَا جَاز	هَالطَلْب مَا جَازْ
زِين	زِيْنْ
أَزيَن مَطعَم	اَزِينْ مَطَعَمْ
رَهِيب	رَهِيبْ
أَعجَبَن المُوَظَّف الّلي	اَعَجِبْنْ الْمَوَظِفْ الْلِي
مَاهُب مُرِيح	مَاهِبْ مَرِيحْ
عَالِي صُوت	عَالِي صَوْتْ
المَطعَم مِن جُوَّا زِين	الْمَطْعَم مِنْ جُوَا زِينْ
هَالمَطعَم جَاز	هَالْمَطْعَم جَازْ
أَزعَجَتنَا رِيحَة	اَزْعَجْتْنَا رِيحَة
مَاهُب	مَاهَبْ
مَاهُب	مَاهَبْ
وِين دَورَات المِياه	وِيْنْ دَوْرَات الْمِيَاه
وِين دَورَةَ	وِيْنْ دُورَة
أَبِي دَورَةَ	اَبِي دُوْرَة
وِين أَغَسِّل	وِينْ اَغْسَلْ
أَبِي الأَكِل	اَبِي الاَكِل
مُمكِن آخِذ هذَا سَفَرِي	مُمْكِنْ اَخْذْ هَذَّا سَفْرِي
استِلِم	اَسْتَلِمْ
أَبَاخِذ البَاقِي	اَبَاخِذ الْبَاقِي
أَبِي طَاولِه	اَبِي طَاوْلْه
أَنَا	اَنَا
عِندِي حَجز	عَنْدِي حَجِّزْ
أَبِي طَاولِه لأَربَع	اِبِي طَاوْلِه لِاَرْبَعْ
أَبِي طَاولِه لثَلَاث	اَبِي طَاوِله لِثْلَاث
صَحَن	صَحْنْ
صَحَن	صَحْنْ
مِلعَقِة	مِلْعَقَة
مِلعَقِة	مِلْعَقَة
مِندِيل	مِنْدِيل
ثَلَاث	ثَلَاثْ
صَحَن كِبِير	صَحْنْ كْبِير
طَاولِه	طَاوْلِه
طَاولِه	طَاوْلْه
جِيبَي	جِيْبِي
أَبِي	ابِي
ويِن الفَاتُورِة	وِيْنْ الفَاتُورَة
وِين فَاتُورَة	وِيْنْ فَاتُورَة
لَو سَمَحت لكِل وَاحِد	لو سَمْحْتْ لكُلْ وَاحِد
الإِيصَال لَو	الْاَيْصَال لوْ
الفَاتُورِه بَه	الفَاتورَه بِه
ويِن الأَسعَار بَالتَّفصِيِل	وَينْ الْاَسْعَار بِالتَّفْصِيل
هَذَا مَا	هَذا مَا
مَاطَلبت	مَاطْلِبْتْ
خَلَّ البَاقِي	خَلْ الْبَاقِي
كَم حسَاب الغَدَاء	كُمْ حِسَاب الْغَدَاءْ
كَم الحسَاب	كُمْ الْحَسَاب
كَم حسَاب العَشَاء	كُمْ حِسَاب الْعَشَاءْ
بكَم البُوفِيهَ المَفتُوح	بِكُمْ الْبُوفِيهْ الْمَفْتُوحْ
الخِدمِه برسُوم	الْخَدْمْهْ بِرَسوم
الخَمِيس فيِه دَوام	الْخَمِيسْ فِيهْ دُوَام
يوم الجِمعِة	يومْ الْجُمْعَة
السَّلَامُ عَلِيكُم وَرَحمَةُ اللهِ	السَّلَام عَلَيْكُمْ وَرْحَمَة الله
السَّلامُ	السَلَامْ
السَّلامُ عَلِيكُم وَرَحمَةُ	السَّلَامْ عَلَيكُمْ وَرْحَمَة
مَسَّاكَ الله	مَسَاك اِلله
صَبَّحكَ الله	صَبْحَكْ الله
مَسَاء	مَسَاءْ
أَنَا	اَنَا
عِندي حَجز	عَنْدِي حَجِّزْ
حَجَزت الغُرفِةَ	حَجَزْتْ الغَرْفَة
غرفِتِي	غَرْفتِي
غرفِه	غَرْفَه
غرفِه	غَرَفْه
غرفِه	غَرْفَه
أَبي غرفِه لشَخصٍ	اِبِي غَرْفَه لِشْخَّصْ
أبِي جَنَاحٍ	اَبِي جِنَاحْ
أَدَوِّر	اَدورْ
غرفِه بِسَرِيرٍ	غَرْفِه بِسْرِير
غرفِه	غَرْفَهُ
جَنَاحٍ خَاص بدُورِتِين	جِنَاحْ خَاصْ بِدُورتِين
ثَلَاث دُورَات	ثَلَاث دَوْرَاتْ
أَربَع دُورَات	اَرْبَعْ دَوْرَاتْ
جَنَاح خَاص بمَجلِس وغِرفِه	جَنَاحْ خَاصْ بِمَجْلِسْ وَغْرَفْهْ
ثَلَاث غرَف نُوم و دَورَتَين	ثَلَاثْ غَرَفْ نُومْ وْ دُورَتِينْ
غرفِتِين نُوم و دَورَة	غَرَفْتِينْ نُومْ وْ دُوْرَة
صُوتِك مُب	صوتِكْ مِبْ
مَا	مَا
مَا أَسمَع	مَا اِسْمَعْ
أَبَتكَلَّم مَع	اَبْتْكَلِمْ مَعْ
أَبَتكَلَّم مَع وَاحِد	اَبْتَكَلَّم مَعْ وَاحِد
عَدِّل	عَدَلْ
يَالِيت	يَالِيتْ
أَدَوِّر	اَدورْ
أنَا أدوّر	اَنَا اَدورْ
تَكفَى تدَوِّر مِعِي فُندِق	تَكْفَى تَدورْ مَعِي فِنْدَقْ
يَالِيت تعِيد لِي أللِّي قِلتَ	يَالِيتْ تَعِيدْ لِي الْلِي قُلْتْ
مَاتَفهَم عَلَي	مَاتْفْهُم عَلِي
مَا فَهَمت وِش	مَا فَهَمْتْ وَشْ
مَا فَهَمتِينِي	مَا فَهَمْتِينِي
مَا فَهَمت	مَا فَهَمْتْ
فَهَمتِي وِش أَقُول	فَهَمْتِي وَشْ اَقولْ
مَا فَهَمتِي وِش	مَا فَهَمْتِي وَشْ
مَا فَهَمتِينِي	مَا فَهَمْتِينِي
ثَلَاث	ثَلَاثْ
دَورَة	دورَةْ
أَبِي مِغسِلَة	اَبِي مَغْسَلَّة
تَحويلَة	تَحْوِيلَة
خِدَمَة تَنظِيف	خَدْمَة تَنْظِيف
مَسئُول تَنظِيف	مَسِيولْ تَنْظِيف
الغرفِه يَبِي لَه	الْغَرْفه يِبِي لَهْ
تَحوِيلَة نَظَافَة	تَحَوِيلَة نِظَافَة
كَم	كمْ
عَطنَا تَحوِيلَة	عَطْنَا تَحَوِيلَة
عَطنَا تَحوِيلَة خِدمَة	عَطْنَا تَحَوِيلَة خِدْمَة
مِين المَسؤُول	مِينْ الْمَسوول
مِنَ المَسئُول	مِنْ الْمَسْيول
خِدمَة	خَدْمَة
مِغسَلَة	مَغْسَلَة
السُّوبَر	السُوبِر
دَورَةَ	دورَةْ
خِدمَةَ	خَدْمَة
فِيه	فِيهْ
فِيه حَمَّامُ	فِيهْ حَمَامْ
أَبِي حَمَّامَ	اِبِي حَمَامْ
فِيه مَسبَح بَالفُندُق	فِيهْ مَسْبَحْ بِالْفَنْدِقْ
لَو سَمَحت وِين المَسبَح	لَو سَمَحْتْ وَيْنْ الْمَسْبَحْ
ودي	وَدِي
وِين المَسبَح	وَيْنْ الْمَسْبَحْ
فيِه مَسبَح أَطفَال	فِيهْ مَسْبَحْ اَطْفَال
مَسَابِح	مَسَابِحْ
وِش المطَاعِم أللِّي بَالفُندُق	وَشْ الْمَطَاعِم الْلِي بِالْفْنْدَقْ
فِيه مَطعَم بَحرِي	فِيهْ مَطْعَمْ بِحَري
مَطَاعِم	مَطَاعِمْ
مَطَاعِم أَكلَهَا	مَطَاعِم اِكْلْهَا
كِلَّ الَأَكِل حَلَال	كُلْ الْاَكْل حَلَال
فِيِه سُوق بَالفُندُق	فِيهْ سوْقْ بِالْفْنْدِقْ
وِش أَقرَب سُوق	وَشْ اِقْرَب سوْقْ
أَسوَاق قِرِيبِة مِن	اَسْوَاق قَرِيبَة مِنْ
وِش أَقرَب سُوق مِن الفُندُق	وَشْ اِقْرَب سُوْقْ مِنْ الْفِنْدَقْ
وِش أَقرَب المَطَاعِم لَلفُندُق	وَش اَقْرَبْ الْمَطَاعِمْ لِلْفِنْدِقْ
فِيِه صَرَّافِة	فِيهْ صَرَافَة
أَبِي	اَبِي
فِيه مَسَاج	فِيهْ مَسَاج
مَسَاج	مَسَاجْ
أَبِي	اَبِي
حَدِيقِه	حَدِيْقُه
بكَم اللِّيلِة	بِكُمْ اللِيلَة
كَم السِّعِر كَامِل	كمْ السَّعْر كَامِل
كِلَّ	كَلْ
عَطنِي الفَاتُورَة لَو	عَطْنِي الْفَاتُورَة لوْ
أقدر أَدفَع كَاش	اَقْدِرْ اِدْفَعْ كَاشْ
أَبَدفَع	اَبْدَفَعَ
تَقبِلُون شِيكَات	تَقْبْلُونْ شِيكَات
مُمكِن أَدفَع شِيك	مُمْكِنْ اِدْفَعْ شِيكْ
شِيك	شِيكْ
أَبَسَدِّد ببِطَاقِةَ	اَبْسَدِد بِبْطَاقَة
أبحَاسِب	اَبْحَاسِبْ
تَشمَل كِل المِصَارِيف	تِشْمَلْ كُلْ الْمَصَارِيف
أَظَفت قِيمَة الوَجَبَات	اَظْفْتْ قِيمَة الوَجِبَاتْ
أَبِي فَاتُورِة	اِبِي فَاتُورَة
فَوَاتِيرَ	فَوَاتِيرْ
عَطنِي الإِيصَال لَو	عَطْنِي الْاَيْصَال لو
لَو سَمَحت عَطنِي الفَوَاتِير	لو سَمْحْتْ عَطْنِي الْفَوَاتِير
عَطنِي	عَطْنِي
مَاستَر	مَاسْتَرْ
فِيزَا	فِيزَا
مَاستَر	مَاسْتَرْ
أَمرِيكَان	اِمْرِيكَان
فِيزَا	فِيزَا
جَدوَل	جَدولْ
مُمكِن أعرِف مَوَاعِيد رِحلَات المغَادَرَة	مُمْكِنْ اَعْرِفْ مَوَاعِيْدْ رَحَلَاتْ الْمَغَادَرَة
أبَسَافِر من الرّياظ	اَبْسافِر مِنْ الرِيَاظ
أَبَسَافر	اَبسافِر
أَبَسَافِر	اَبَسافِر
مِتَى تُوصَل	مَتى تُوْصِلْ
كَم رِحلة بتِجِي	كُمْ رِحْلَة بِتْجِي
كَم رِحلِة بِترُوح	كُمْ رَحْلَة بِتْرُوحْ
مِتَى مَوعِد الرِّحلَات	مَتى مَوَعْدْ الرَحْلَاتْ
مِتَى مَوعِد رِحلَة جِدِّة	مَتّى مَوَعْدْ رَحْلَة جِدَة
مِتَى وُصُول رِحلَة وَاحِد اِثنِين	مَتّى وَصولْ رِحْلَة وَاحِد اِثْنِينْ
مَوعِد وُصُول الرِّحلَة	مَوَعْدْ وَصولْ الرِّحْلَة
مَوعِد وُصُول الرِّحلِة رَقِم ثَلاثِة اِثنِين	مَوَعْدْ وَصولْ الْرِّحْلَة رَقَمْ ثْلَاثَة اِثْنِينْ
عَدِّل لَو	عَدْلْ لُو
لَو سَمَحت عَدِّل	لو سَمْحْتْ عَدَلْ
غَيِّر مَوعِد الحَجز	غَيْر مَوَعْدْ الْحَجْزْ
رَقِم	رَقْمْ
مُمكِن تِعِيد عَلَيَّ	مُمْكِنْ تَعِيدْ عَلِي
أَبَكَلِّم	اَبْكِلْم
أَبَكَلِّم أَحَد	اَبْكَلِم اَحَدْ
أَبَسَافِر	ابسَافِر
أَبَلغِي	اَبْلَغِي
هَالحَجز	هَالْحَجّزْ
أبَدفَع فلُوس	اَبْدَفَعْ فْلُوسْ
كَم فلُوس كِلَّ التَّذَاكِر	كمْ فِلُوسْ كُلْ الْتَّذَاكُرْ
مَجمُوع	مَجْمُوعْ
كَم كَامِل المَبلَغ	كمْ كَامِلْ الْمَبْلَغْ
أبدفَع فلُوس التَّذكِرَة	اَبْدَفَعْ فَلُوسْ الْتَّذْكَرَة
أبَدفَع	اِبْدَفْعْ
رَقِم التَّذكِرَة	رَقَّمْ الْتَّذْكْرَة
كَم رَقِم التَّذكِرَة الإكتُرُونيِّة	كُمْ رَقَمْ الْتَذْكْرَة الْاِكْتِرُونِيَة
أَقِصَّ	اَقْصْ
أَبَطبَع	ابْطَبَعْ
تَكفَى غَيِّر	تَكْفَى غِيْرْ
أَبَغَيِّر	اِبْغِير
تَقدَر تأَكِّد لِي	تَقَدَّرْ تَاكِدْ لِي
بجَنب	بجنب
عَلَى	عَلَى
حُول مَخرَجِ	حَوَلْ مَخْرَجْ
كَم رَقِم بَوَّابَة	كَمْ رَقَّمْ بْوَابَة
أَبِي رَقِم	اَبِي رَقَمْ
رَقِم الحَجز	رَقَمْ الْحَجِزْ
أَبِي رَقِم	اَبِي رَقَمْ
أَبَعَرِف رَقِم	اِبْعَرَف رَقمْ
أَبَعَرِف رَقِم	ابعرف رَقم
أَبَعَرِف رَقِم	اَبَعرَف رَقَمْ
أَبَأَكِّد	اَبَاكِدْ
أَبَعَرِف وَقت	اَبْعَرَف وَقَتْ
أَبَعَرِف وَقت	اَبْعَرَف وَقْتْ
مُب وَاظِح	مَبْ وَاظِحْ
مَا	مَا
مَا أَقدَر أَسمَع	مَا اَقْدَرْ اِسْمَعْ
صُوتِك	صوتِكْ
حَجزٍ جِدِيد	حَجْزْ جَدِيدْ
أَبَعَرِف وَقتَ	اِبْعَرَف وَقْتْ
تَأَخَّرَت	تَاخْرَتْ
تَبِي تِطِير الطِّيَّارِه	تِبِي تَطِيرْ الطَّيَارَه
الرِّحلِة عَلَى نَفسَ	الرِحْلَة عَلَى نَفْس
الرِّحلِة تَأَخَّرَت	الرَحْلَة تَاخَرَتْ
الصَّالِه	الصَالِه
الصَّالِه	الصَالِه
الصَّالِه	الصَالِه
الصَّالَات	الصَالَاتْ
صَالَة	صَالَة
صَالَة	صَالَة
صَالَات الخُطُوط	صَالَاتْ الْخَطُوطْ
الخُطُوط	الْخَطُوطْ
هَذِي	هَذي
هَذَا	هَذَّا
سَبِع	سَبْعْ
خَمس	خمس
عَرَبَة	عَرَبَة
إِيه هَالقِطعِة	اَيْهْ هَالْقُطْعَة
إِيه أَنَا	اِيْهْ اَنَا
مِكَان التِّكَاسِي	مَكَان التَّكَاسِي
وِين الدَّرب لفُندِقَ	وَينْ الدَّرْبْ لِفْنْدِقْ
أَقرَب	اَقْرَبْ
أَدَوِّر	اَدورْ
أَنَا	اَنَا
أَبِي	اَبِي
أَبِي	اَبِي
أَبِي	اَبِي
تَقدَر	تْقَدْرْ
أَبغَى	اَبْغَى
أَبِي مِكَان	اَبِي مَكَانْ
وِشَ أَقرَب	وَشْ اِقْرَبْ
أَدَوِّر	اَدورْ
أَدَوِّر أَقرَب	اَدورْ اَقْرَبْ
أَبِي	اَبِي
أَبِي	اَبِي
أَنَا أَبِي	اَنَا اَبِي
أَبِي	اَبِي
أَبِي	اَبِي
أَبِي	اَبِي
كَم بِين الرِّيَاظ	كُمْ بِينْ الرِيَاظْ
تَاكسِي كِبِير لَا	تَاكْسِي كَبِيرْ لَا
أَبِي	اَبِي
وِدِّي أَدرِي الطِّرِيق	وَدِي اِدْرِي الطَرِيقْ
هُو فِيه	هُو فِيهْ
كَمَّ	كمْ
كَم سِعرَ	كمْ سَعْرْ
وشُّو	وَشوْ
وَصِّف	وَصفْ
لَا هِنت تِعطِين	لَا هَنْتْ تَعْطِينْ
وشَ أقرَب دَرب ل	وَشْ اَقْرَب دَرْب ل
أَقدَر أَدِقّ	اَقْدَرْ اِدْق
وِشلُون أَقدَرَ أَدِقّ	وَشْلُونْ اَقْدِرْ اِدْقْ
وشُّو مِفتَاح	وَشو مِفْتَاح
وشُّو مِفتَاح	وَشُّو مِفْتَاح
كِيف أَجوَاء	كِيفْ اَجْوَاء
كِيف أَجوَاء	كِيفْ اَجْوَاء
كِيفَ	كِيفْ
كَمَّ المَسَافِة	كَمْ الْمَسَافَة
كَم دَرَجَةَ الحَرَارِة	كُمْ دَرْجَة الْحَرَارَة
الله لَا يهِينِك أَقرَب	الله لَا يِهِينَكْ اَقْرَبْ
مِتَى تَطلَعَ	مَتى تَطْلَعْ
مِتَى تِغِيب	مَتَى تَغِيبْ
أَبِي	اَبِي
وِين مُجَمَّعَ	وَيْنْ مَجْمَعْ
وِشَ أَقرَب	وَش اِقْرَبْ
أَبَستَفسِر عَن	اَبْسَتِفْسِرْ عَنْ
بكَم هِي بُه	بِكُمْ هِي بَه
هَذِي	هَذي
كَم سِعِر	كمْ سَعْرْ
كَم سِعِر	كمْ سَعَّرْ
هَذَا بكَم هُو	هَذا بِكُمْ هُو
هَالقِطعِة كَم	هَالْقَطْعَة كُمْ
أَبَستَفسِر عَن	اَبْسَتْفْسِرْ عَنْ
أَبَستَفسِر عَن	اَبْسَتْفَسِر عنْ
أَبَتَأَكَّد مِن	اَبْتَاكِدْ مِنْ
أَبَشتِرِي	اِبْشَتْرِي
أَبِي أَعَرِف مِتَى يِنتِهِي	اَبِي اَعْرَف مَتَى يِنْتَهِي
أَبِي أَعَرِف كَم	اِبِي اَعْرَفْ كَمْ
أَبِي أَعَرِف	اَبِي اَعْرَفْ
مُب وَاظِح	مَبْ وَاظِحْ
مَا	مَا
مَا أَقدَر	مَا اَقْدَرْ
صُوتِك	صوتِكْ
دَوَامِكُم مِن مِتَى	دوامْكُمْ مِنْ مَتَى
مِتَى يَبدَأ	مَتَى يِبْدَا
مِتَى يِنتِهِي	مَتى يِنْتَهِي
مَحَلّكُم مِتَى	مَحْلْكُمْ مَتَى
مَحَلِّكُم مِتَى	مَحْلْكُمْ مَتَى
مُب	مَبْ
أَبِي	اَبِي
وِين مَحَلَّ	ويْنْ مَحَلْ
مَحَلَّات الجُملِة	مَحَلَاتْ الْجُمْلَة
أَبِي أَعَرف	اِبِي اَعْرَفْ
المَوقِع الرَّئِيسِي لَشَّرِكِه	الْمُوْقِعْ الْرِييْسِي لِشْرَكه
جُوَّا السُّوق فِيه	جَوَّا الْسُوقْ فِيهْ
وِين أَقرَب	وِيْنْ اَقْرَبْ
مَحَلَّات	مَحَلَاتْ
وِشلُون تَقدُرُون	وَشْلُونْ تَقْدْرُونْ
عِندِي حَالَة	عَنْدِي حَالَة
الدَّوَام مِن مِتَى	الدَّوَام مِنْ مَتَى
فِيه دَوَام يُومَ	فِيهْ دَوَام يوم
وِين دُورَات	وِيْنْ دُوْرَاتْ
وِين دُورَةَ	وِيْنْ دُورَة
اَلله لَايهِينِك وِين دُورَةَ	الله لِايْهِينَكْ وِيْنْ دُورَة
فِيه حُولِنَا دُورَات	فِيهْ حُولْنَا دُوْرَاتْ
وِين أَقرَب دُورَات	وِيْنْ اَقْرَبْ دُوْرَات
غَاليِه	غَالِيهْ
المَلَابِس	الْمَلَابِس
المَلَابِس	الْمَلَابِسْ
أَيَّامَ	اَيَام
نِهَايَةَ	نِهَايَة
إِجَازَةَ	اَجَازَة
الخَمِيس	الْخَمِيسْ
بَعد	بَعَدْ
بَعد	بَعَدْ
بَعد	بَعَدْ
بَعد	بَعَدْ
بَعدَ	بَعَدْ
بَعدَ	بَعَدْ
بَعدَ	بَعَدْ
بَعدَ	بِعَدْ
بَعدَ	بَعْدْ
بَعدَ	بَعَدْ
بَعدَ	بَعَدْ
بَعدَ	بَعدْ
بَعدَ	بَعَدْ
بَعدَ	بَعدْ
بَعدَ	بَعَدْ
بَعدَ	بَعَدْ
بَعدَ	بَعَدْ
بَعد	بَعَدْ
بَعد	بَعَدْ
بَعد	بَعَدْ
بَعد	بَعَدْ
بَعد	بَعْدْ
عِقُب إِجَازَة نِهَايَةِ	عَقْبْ اَجَازَة نِهَايَة
بَعد جُمَاد	بَعَدْ جَمَاد
بَعد جُمَاد	بَعَدْ جْمَادْ
بَعد جُمَاد	بَعَدْ جَمَاد
بَعد	بَعَدْ
بَعد	بَعَدْ
بَعد ذِي	بَعَدْ ذِي
بَعد ذِي	بَعَدْ ذِي
بَعد رِبِيع	بَعَدْ رَبِيعْ
بَعد رِبِيع	بَعَدْ رَبِيعْ
بَالشَّهرَ	بِالشَّهْرْ
بَالعَامِ	بِالعَامْ
بَالسِّنِة	بَالْسِنَة
بَالعَامَ	بِالعَام
بَالعَامَ	بِالعَام
بإِجَازَة نِهَايَة	بَاجَازَة نِهَايَة
بجُمَادَى	بِجْمَادَى
بجُمَادَى	بِجْمَادَى
بجُمَادَى	بِجمَادَى
بذِي	بِذي
بذِي	بِذي
برَبِيعَ	بَرْبِيعْ
برَبِيع	بِرْبِيعْ
برَبِيع	بَرْبِيعْ
قَبلَ	قَبَّلْ
قَبلَ	قَبَّلْ
قَبلَ	قَبْلْ
قَبلَ	قَبَّلْ
قَبلَ	قَبْلْ
قَبلَ	قَبْلْ
قَبلَ	قَبَّلْ
قَبلَ	قَبَّلْ
قَبلَ	قَبَّلْ
قَبلَ الشَّهرِ	قَبَّلْ الشَّهْرْ
قَبلَ	قَبْلْ
قَبلَ	قَبَّلْ
قَبلَ	قَبْلْ
قَبلَ العَامَ	قَبْلْ الْعَامْ
قَبلَ العَامَ	قَبَّلْ الْعَام
قَبلَ العَامَ	قَبَّلْ الْعَام
قَبلَ العَامَ	قَبَلْ الْعَام
قَبلَ	قَبَّلْ
قَبلَ	قَبْلْ
قَبلَ	قَبَّلْ
قَبلَ	قَبْلْ
قَبلَ	قَبْلْ
قَبِل	قَبَّلْ
قَبِل	قَبْلْ
قَبِل	قَبَّلْ
قَبِل	قَبَّلْ
قَبِل	قَبَّلْ
قَبِلَ	قَبَّلْ
قَبِل	قَبْلْ
قَبِل إِجَازَة نِهَايَةَ	قَبْلْ اَجَازَة نِهَايَة
قَبِل	قَبَّلْ
قَبِل جُمَاد	قُبَّلْ جَمَاد
قَبِل جُمَاد	قَبْلْ جَمَادْ
قَبِل جُمَاد	قَبَّلْ جَمَاد
قَبِل	قَبَّلْ
قَبِل	قَبْلْ
قَبِل ذِي	قَبَّلْ ذِيْ
قَبِل ذِي	قَبَّلْ ذِيْ
قَبِل رِبِيعَ	قَبَّلْ رَبِيعْ
قَبِل رِبِيعَ	قَبْلْ رَبِيعْ
قَبِل	قَبْلْ
قَبِل	قَبَّلْ
قَبِل	قَبْلْ
قَبِل	قَبَّلْ
بَعد رِبِيع	بَعَدْ رَبِيعْ
بَعد	بَعَدْ
بَعد	بَعَدْ
بَعد	بَعَدْ
بَعد	بَعَدْ
بَعد	بَعَدْ
بَعد	بَعَدْ
بَعد	بَعَدْ
بَعد	بَعَدْ
بَعد	بَعَدْ
بَعد	بَعَدْ
بَعد	بَعَدْ
بَعد عَشِر	بَعَدْ عَشَرْ
بَعد عِيدَ	بَعَدْ عَيْدْ
بَعد عِيدَ	بَعدْ عَيْدْ
بَعد	بَعَدْ
بَعد	بَعَدْ
بَعد	بَعَدْ
بَعد	بَعَدْ
بَعد	بَعَدْ
بَالاِسبُوعَ	بِالْاَسْبُوعْ
بعَام أَلف وَاربَعمِيِّة وثَلَاثُ وثَلاثِين	بِعَام اَلْف وَارْبَعْمِيَّة وَثْلَاثْ وَثَلَاثِينْ
بعَام أَلفين وَاثنَعَش	بِعَامْ اَلْفِينْ وَاثْنَعْشْ
بعِيد	بَعِيدْ
بعِيد	بْعِيدْ
بكَانُونَ	بْكَانُونْ
بكَانُونَ	بكَانُونّ
بهَا	بهَا
قَبلِ	قَبْلْ
قَبِلَ	قَبَّلْ
قَبِلَ	قَبْلْ
قَبِلَ الاِسبُوع	قَبَّلْ الْاَسْبُوعْ
قَبلَ	قَبْلْ
قَبِل	قَبْلْ
قَبِل	قَبَّلْ
قَبِل	قَبَّلْ
قَبِل	قَبَّلْ
قَبِل	قَبْلْ
قَبِل	قَبْلْ
قَبِل	قَبْلْ
قَبِل سَنَة أَلف وَاربَعمِيِّة وثَلَاثُ وثَلاثِين	قَبَّلْ سِنَّة اَلْف وَارْبَعْمِيَّة وَثْلَاثْ وَثَلَاثِينْ
قَبِل سَنَة أَلفين وَاثنَعَش	قَبَّلْ سِنَّة اَلْفِينْ وَاثْنَعْشْ
قَبِل عِيدَ	قَبَّلْ عِيْد
قَبِل عِيدَ	قَبَّلْ عِيْدْ
قَبِل	قَبْلْ
قَبِل	قَبْلْ
قَبِل	قَبَّلْ
قَبِل	قَبْلْ
قَبِل	قَبْلْ
قَبِل	قَبَّلْ
قَبِل	قَبَّلْ
قَبِل	قَبَّلْ
قَبِل	قَبَّلْ
أَحمَد	اَحْمَدْ
أَدِيس	اَدِيسْ
إِسبرِنق	اسْبَرْنقْ
إِسلام	اَسْلَامْ
الدَّارَ	الدَارْ
أُم	اَمْ
إِندِيَانَا	اِنْدِيَانَا
بَاتُون	بَاتون
بِيُونِس	بِيونِس
دَارَ	دَارْ
دِي	دِيْ
رِيُو دِي	رِيو دِي
سَان	سَان
سَاند	سانْدْ
سَاو	سَاوْ
كِيب	كِيبْ
لاس	لَاسْ
لُوس	لُوسْ
مِكسِيكُو	مَكْسِيكُو
بُور	بورْ
هَافَانَا	هَافَانَا
هُونج	هونَجْ
وَاشُنطُن دِي	وَاشْنْطُنْ دِي
ثَلَاث	ثَلَاثْ
أَربَع	اَرْبَعَ
خَمس	خَمَسْ
سِتَّ	ست
سَبِع	سَبْعْ
ثِمَان	ثَمَانْ
تِسِع	تَسَعْ
وَاحِدُ و	وَاحِد وْ
اِثنِينُ	اثنِينْ
ثَلَاثُ وُ	ثَلَاث 
أَربَعُ وُ	اَرْبَعْ 
خَمسُ و	خَمَسْ 
سِتُّ و	ست 
سَبِعُ و	سَبْع 
ثِمَانُ و	ثَمَان 
تِسِعُ و	تَسعْ 
وَاحِدُ و	وَاحِد وْ
اِثنِينُ و	اَثْنِينْ وْ
ثَلَاثُ و	ثَلَاث 
أَربَعُ و	اَرْبَعَ وْ
خَمسُ و	خَمْسْ وْ
سِتُّ و	سَت 
سَبعُ و	سَبْعْ 
ثِمَانُ و	ثَمَان و
تِسعُ	تَسْعْ
وَاحِد	وَاحْدْ
اِثنِين	اَثْنِينْ
ثَلاث	ثَلَاثْ
أَربَع	اَرْبَعْ
خَمس	خَمَسْ
سِت	ست
سَبع	سَبْعْ
ثِمَان	ثَمَانْ
تِسع	تَسْعْ
وَاحِد	وَاحِدْ
اِثنِين	اَثْنِينْ
ثَلَاث	ثَلَاثْ
أَربَع	اَرْبَعْ
خَمس	خَمْسْ
سِت	ست
سَبِع	سَبْعَ
ثِمَان	ثمَان
تِسِع	تَسْعَ
وَاحِدُ	وَاحِدْ
اِثنِينُ	اثنِيْن
ثَلاثُ	ثَلَاثْ
أَربَعُ	اَرْبَعَ
خَمسُ	خَمَّسْ
سِتُّ	ست
سَبعُ	سبعْ
ثِمَانُ	ثَمَان
تِسعُ	تَسْعْ
وَاحِدُ	وَاحْدْ
اِثنِينُ	اثنِينْ
ثَلُاثُ	ثَلَاثْ
أَربَعُ	اَرْبَعْ
خَمسُ	خَمْسْ
سِتُّ	ست
سَبعُ	سَبْعْ
ثمَانُ	ثمَان
تِسعُ	تَسْعْ
وَاحِدُ	وَاحِدْ
اِثنِينُ	اثنين
ثَلَاثُ	ثَلَاثْ
أَربَعُ	اَرْبَعَ
خَمسُ	خَمَسْ
سِتُّ	ست
سَبِعُ	سَبْعْ
ثِمَانُ	ثَمَان
تِسِعُ	تَسْعْ
وَاحِدُ	وَاحْدْ
اِثنِينُ	اثنين
ثَلَاثُ	ثَلَاثْ
أَربَعُ	اَرْبَعْ
خَمسُ	خمسْ
سِتُّ	ست
سَبِعُ	سَبْعْ
ثِمَانُ	ثَمَان
تِسعُ	تَسْعْ
اِثنَا	اثْنا
اِثنَتَا	اِثْنَتَا
اِثنَتَي	اِثْنْتِي
اِثنَي	اِثْنِي
أَحَدَ	اَحَدْ
أَربَعَ	اَرْبَعَ
أَربَعَة	اَرْبَعَة
إِحدَى	اَحْدَى
تِسعَ	تَسْعَ
تِسعَةَ	تِسْعَة
ثَلاثَ	ثَلَاثْ
ثَلاثَةَ	ثَلَاثَة
ثَمَانِيَ	ثَمَانِي
ثَمَانِيَةَ	ثَمَانِيَة
خَمسَ	خَمْسَ
خَمسَةَ	خَمْسَة
سَبعَ	سَبْعْ
سَبعَةَ	سَبْعَة
سِتَّ	ست
سِتَّةَ	سَتة
السَّلَامُ عَلَيكُم	السَّلَام عَلَيْكُمْ
السَّلَامُ عَلَيكُم وَرَحمَةُ اللهِ وَبَرَكَاتُه	السَّلَامْ عَلَيْكُمْ وَرْحْمَة الله وَبْرَكَاتُه
هَل تَسمَحُ لِي	هَلْ تَسْمَحْ لِي
لَو سَمَحت	لو سَمَحَتْ
مِن فَضلِك	مِنْ فِضْلَكْ
هَل تَتَكَرَّمُ عَلَيَّ بِ	هَلْ تِتْكَرَم عَلِي ب
مِن فَضلِكَ أُرِيد	مِنْ فَضْلِكْ اَرِيدْ
أَنَا أُرِيدُ مِن فَضلِك	اَنَا اَرِيدْ مِنْ فِضْلَكْ
مِن فَضلِكَ أَحضِر لِي	مِنْ فِضْلَكْ اَحْضَرْ لِي
هَل لَدَيكَ حَجز	هَلْ لِدِيكْ حَجِّزْ
اِنتَظِر قَلِيلا	اَنْتَظْر قَلِيلَا
سَأَنتَظِرُ هُنَا	سَانْتَظْر هَنَا
مَتَى يُغلَقُ المَطعَم	مَتَى يَغْلَقْ الْمَطْعَمْ
مَتَى يُفتَحُ المَطعَم	مَتّى يِفْتَحْ الْمَطْعَمْ
هَل يُقَدِّمُ المَطعَمُ وَجبَةَ الفُطُور	هَلْ يِقْدِم الْمَطْعَم وَجْبَة الْفَطُورْ
هَل يُقَدِّمُ وَجبَةَ العَشَاءِ وَالغَدَاء	هَلْ يِقْدِم وَجْبَة الْعَشَاء وَالْغَدَاءْ
هَل يُقَدِّمُ المَطعَمُ وَجبَةَ عَشَاء	هَلْ يِقْدِم الْمَطْعَم وَجْبَة عَشَاء
الصَّوتُ غَيرُ وَاضِح	الصوْتْ غَيْرْ وَاضِح
لَا أَسمَعُك	لَا اِسْمَعَك
لَا أَستَطِيعُ سَمَاعَ صَوتِك	لَا اِسْتَطِيع سْمَاعْ صُوتَكْ
صَوتُكَ مُنخَفِض	صوتِكْ مُنْخَفِضْ
آمُلُ التَّصحِيح	اَمَّلْ التَّصَحِيح
أَرجُو التَّعدِيل	اَرْجُو الْتَّعْدِيلْ
أَرجُو أَن تعُيِدَ عَلَيَّ المَعلُومَاتَ الَّتِي ذَكَرتُهَا	اَرْجُو اَنْ تَعِيدْ عَلِي الْمَعْلُومَاتْ الْتِي ذَكْرْتْهَا
أُرِيدُ التَّحَدُّثَ مَعَ المَسؤُول	اَرِيدْ الْتَّحْدِثْ مَعْ الْمَسُوول
مَن هُوَ المَسئُول	مِنْ هُو الْمَسْيولْ
لا أَفهَمُ مَا تَقُول	لَا اَفْهَمْ مَا تَقولْ
لا تَفهَمُ مَا أَقُول	لَا تَفْهَمْ مَا اَقول
لَم تَفهَم مَا أُرِيد	لَم تَفْهَم مَا اَرِيدْ
لَم تَفهَمِينِي	لَم تَفْهَمِينِي
لا أَفهَمُ مَا تَقُولِين	لَا اَفْهَمْ مَا تَقولِينْ
لا تَفهَمِينَ مَا أَقُول	لَا تَفْهَمِينْ مَا اَقول
لَم تَفهَمِي مَا أُرِيد	لَم تَفْهَمِي مَا ارِيدْ
لَم تَفهَمِينِي	لَم تَفْهَمِينِي
هَل يُوَجُدُ مَكَانٌ مُخَصَّصٌ لِغَيرِ المُدَخِّنِين	هَلْ يوجِدْ مَكَان مَخَصِّصْ لِغِيْرْ الْمُدْخْنِينْ
هَل لَدَيكُم قِسمٌ لِغَيرِ المُدَخِّنِين	هَلْ لِدِيكُم قَسْمْ لْغِيْرْ المُدْخْنِينْ
أُرِيدُ المَكَانَ المُخَصَّصَ لِغَيرِ المُدَخِّنِين	اَرِيدْ المَكَان الْمُخْصِصْ لِغِيْرْ الْمُدْخْنِينْ
أَينَ المَكَانُ المُخَصَّصُ لِغَيرِ المُدَخِّنِين	اَيْنْ الْمَكَان الْمُخْصِصْ لِغِيْرْ الْمُدْخْنِينْ
أَينَ المَكَانُ المُخَصَّصُ لِلمُدَخِّنِين	اَيْنْ المَكَان الْمُخْصِصْ لِلْمُدْخنِينْ
عُذرًا أَنَا آسِف	عَذْرَا اَنَا اَسَّفْ
أَعتَذِرُ أَنَا آسِف	اَعْتَذِرْ اَنَا اَسَّفْ
تَكَرُّمًا	تَكْرْمَا
لَو سَمَحتِ	لو سِمْحَتْ
نَعَم	نَعَمْ
لا	لَا
حَسَنًا	حَسْنًا
طَيِّب	طِيْبْ
شُكرًا	شَكْرَا
شُكرًا لَك	شَكْرَا لَكْ
شُكرًا لَكِ	شُكْرَا لَكْ
لا أُرِيد	لَا اَرِيدْ
لا أَستَطِيع	لَا اِسْتَطِيعْ
لا أَرغَب	لَا اَرْغَبْ
أنَا آسِف	اَنَا اَسَّفْ
اُعذُرنِي	اعذرنِي
اُعذُرِينِي	اعْذْرِينِي
أَنَا أَعتَذِرُ بِشِدَّة	اَنَا اَعْتَذِرْ بِشَدَّة
مَا أَنوَاعُ تَتبِيلَةَ السَّلَطَة	مَا اَنْوَاعْ تَتْبِيلَة السُلْطَة
مَاهِيَ أَنوَاعُ السَّلَطَاتِ لَدَيكُم	مَاهِي اَنْوَاعْ السُلْطَات لِدِيْكُم
مَا أَنوَاعُ السَّلَطَاتِ الّتِي تُقَدِّمُونَهَا	مَا اَنْوَاعْ السّلْطَات الْتِي تَقْدِمُونَهَا
مِن فَضلِكَ أُرِيدُ قَهوَة	مِنْ فِضْلِكْ اَرِيدْ قَهوَة
أُرِيدُ كُوبًا مِنَ القَهوَة	اَرِيدْ كُوبَا مِنْ الْقَهوَة
أَحضِرِ القَهوَةَ أَوَّلاً	اَحْضِر الْقُهْوَة اَوْلَا
أَحضِرِي القَهوَة	اَحْضَرِي الْقَهوَة
مِن فَضلِكِ أُرِيدُ شَاي	مِنْ فِضْلِكْ اَرِيدْ شَاي
أُرِيدُ فِنجَانَ شَايٍ أَوَّلا	اَرِيدْ فِنْجَانْ شَايْ اولَا
جَهِّزِي لَنَا الشَّايَ بَعدَ العَشَاء	جَهْزِي لِنَا الْشَايْ بَعَدْ الْعَشَاء
مِن فَضلِكِ أُرِيدُ الطَّعَامَ الآن	مِنْ فِضْلِكْ اَرِيدْ الطَّعَام الْاَنْ
أَحضِرِ السَّلَطَاتَ قَبلَ الطَّعَام	اَحْضَرْ السُّلْطَاتْ قَبَلْ الطَعَامْ
أُرِيدُ سِبرَايت	اَريد سِبْرَايِت
أُرِيدُ مَشرُوبَ الكولا	اَرِيدْ مَشْرُوبْ الكُولَا
أَحضِر لَنَا بِبسِي	اَحْضَر لِنَا بِبْسِي
أَحتَاجُ بَعضَ الوَقتِ لِأَختَارَ الطَّعَام	اَحْتَاج بَعْضْ الوَقْتْ لِاَخْتَارْ الطَّعَامْ
أُرِيدُ قَائِمَةَ الطَّعَام	اَرِيدْ قَايِمَة الطّعَامْ
لَستُ جَاهِزًا للطَّلَبِ بَعد	لِسْتْ جَاهْزَا لِلْطَّلْب بَعَدْ
لَم أُقَرِّر بَعد	لَم اَقْرَر بَعَدْ
أَعطِينِي بَعضَ الوَقتِ لأُقَرِّر	اَعْطِينِي بَعْضْ الْوَقْتْ لاقْرِرْ
أَحتَاجُ بَعضَ الوَقتِ لأُقَرِّر	اَحْتَاج بَعْضْ الْوَقْتْ لِاَقْرِرْ
مَا أَنوَاعُ الأَكلِ الَّتِي يُوَفِّرُهَا المَطعَم	مَا اَنْوَاعْ الْاَكْل التِي يُوفِرْهَا الْمَطْعَم
مَاذَا تَقتَرِحُ أَن نَأكُل	مَاذا تَقْتَرِحْ اَنْ ِنَاكُلْ
وَجبَةَ الإِفطَار	وَجْبَة الْافْطَار
شُوربَةُ خُضَارٍ مَعَ زَيتِ الزَّيتُون	شورْبَة خَضَارْ مَعْ زِيْتْ الزِيتُون
عَسَلٌ وَجُبنٌ وَمُرَبَّى الفَرَاوِلَة	عَسْلْ وَجْبْنْ وَمَرْبَى الْفَرَاوْلَة
حَلاوَةُ طَحِينِيَّةَ مَع زُبدَةِ الفُولِ السُّودَانِي	حَلَاوَة طَحِينِيَة مَعْ زِبْدَة الْفُولْ السُّودَانِي
مَا هِيَ اقتِرَاحَاتُكِ لِلأَكل	مَا هِي اِقْتِرَاحَاتَكْ لِلْاكِل
مَا نَوعُ شُوربَةُ اليَوم	مَا نُوعْ شُورْبَة الْيوم
مَا هُوَ طَبَقُ اليَوم	مَا هُو طَبْقْ اليُّوم
دَجَاجٌ مَشوِي	دَجَاجْ مَشوي
لَحمٌ مَعَ الرُّز	لِحَمْ مَعْ الرَّز
رُزٌّ مَعَ اللَّحم	رَز مَعْ اللحَمْ
رُزٌّ مَعَ الدَّجَاج	رَزْ مَعْ الْدَّجَاجْ
مَشَاوِي مُشَكَّلَة	مَشَاوِي مَشْكِلَة
أَكَلاتٌ بَحرِيَّة	اَكْلَاتْ بِحَرِيَة
بِالنِّسبَةِ لِي أُفَضِّلُ الأَكلَ النَّبَاتِي	بِالْنِّسْبَة لِي اَفْضَلْ الْاَكْل الْنِبَاتِي
صِحَّةٌ وَعَافِيَة	صَحَّة وَعَافِيَة
أُرِيدُ الخُبز	اَرِيدْ الخَبْزْ
مَزِيدٌ مِنَ الخُبز	مَزِيدْ مِنْ الْخَبْزْ
بِمَاذَا تَنصَحُنَا	بِمَاذَا تَنْصَحْنَا
بِمَاذَا تَنصَحِين	بِمَاذَا تَنْصَحِينْ
مَا أَفضَلُ وَجبَةٍ تُقَدِّمُونَها	مَا اَفْضَلْ وَجْبَة تَقْدِمُونهَا
أَفضَلُ الوَجَبَاتِ لَدَيكُم	اَفَّضَلْ الْوَجْبَاتْ لِدِيْكُم
أَحضِرِ المُقَبِّلَاتِ ثُمَّ أَحضِر بَاقِيَ الطَّعَام	اَحْضَرْ الْمُقْبِلَاتْ ثُمْ اَحْضَرْ بَاقِي الطَعَامْ
هَل لَدَيكُم بُوفِيهٌ مَفتُوح	هَلْ لِدِيكُم بُوفِيهْ مَفْتُوح
مَا هِيَ الأَنوَاعُ التِي تُقَدِّمُونَهَا فِي البُوفِيهِ المَفتُوح	مَا هِي الْاَنْوَاعْ الْتِي تَقْدِمُونْهَا فِي الْبُوفِيه الْمَفْتُوحْ
هَل جَمِيعُ الأَصنَاِفِ حَلال	هَلْ جَمِيعْ الْاَصْنَاف حَلَال
مَا أَنوَاعُ العَصَائِرَ التِي تُقَدِّمُونَهَا	مَا اَنْوَاعْ الْعَصَايِر التِي تَقَدْمُونهَا
عَصِيرُ بُرتُقَال	عَصِيْرْ بِرْتَقَالْ
فُولٌ وَعَدَس	فُولْ وَعَدْسْ
خُبزٌ صَامُولِيّ وَخُبزٌ مَفرُود	خَبْز صَامُولِي وْخَبْزْ مَفْرُودْ
أَربَعُ خُبزَاتُ تَمِيس	اَرْبَعْ خَبْزَاتْ تْمِيْسْ
فُولٌ وَمُطَبَّق	فُولْ وَمْطَبَقْ
عَصِيرٌ مُشَكَّل	عَصِيْرْ مَشَكِلْ
عَصِيرُ فَوَاكِهَ مُشَكَّلَة	عَصِيرْ فَوَاكِه مَشْكِلَة
عَصِيرُ بُرتُقَالٍ وَلَيمُون	عَصِيرْ بِرْتْقَالْ وَلِيْمُونْ
ثَلاثُ خُبزَات	ثَلَاث خَبْزَاتْ
خُبزَتَين	خَبْزَتِين
خُبزَة	خَبْزَة
سِكِّين	سَكِيْن
شَوكَة	شوكَة
مِلعَقَة	مِلْعَقَة
مِلعَقَةٌ صَغِيرَة	مِلْعَقَة صَغِيرَة
صَحن	صَحْنْ
صَحنٌ كَبِير	صَحْنْ كْبِيرْ
صَحنٌ صَغِير	صَحِنْ صَغِيرْ
أَنَا جَائِع	اَنَا جَايَعْ
أَنَا عَطشَان	اَنَا عَطَّشَانْ
أُرِيدُ مَاء	اَرِيدْ مَاءْ
حُمَّص	حَمَّصْ
كَبَاب	كَبَابْ
أَوصَال	اَوْصَالْ
شُوربَةُ عَدَس	شورْبَة عَدْسْ
شُوربَةُ خُضَار	شُورِبَة خَضَارْ
شُوربَةُ دَجَاج	شورَبَة دَجَاجْ
شُوربَةُ حَرِيرَة	شورْبَة حَرِيرَة
عَسَل	عَسَلْ
جُبن	جَبْنْ
مُقَبِّلَات	مُقْبَلَاتْ
حَلوَى	حَلَوَى
لَم يَكُنِ الأَكلُ جَيِّدًا	لَمْ يِكُن الْاَكْل جِيدَا
كَانَ العَشَاءُ لَذِيذًا	كَان الْعَشَاء لِذِيذَا
هَذَا مِن أَفضَلِ الأَطبَاقِ الّتِي تَذَوَّقتُهَا	هَذا مِنْ اَفْضَلْ الْاَطْبَاق الْتِي تَذْوْقْتهَا
إِنَّهُ أَفضَلُ طَبَقٍ تَذَوَّقتُه	اِنْه اَفْضَلْ طِبْقْ تَذوْقْته
هَذَا الطَّبَقُ لَذِيذ	هَذا الطَّبْق لِذِيْذْ
لَم يَكُن هَذَا الطَّبَقُ بِالمُستَوَى المَطلُوب	لَم يكُن هَذَا الطَّبْقْ بِالْمُسْتَوَى الْمَطْلُوبْ
هَذَا المَطعَمُ رَائِع	هَذا الْمَطْعَم رَايَعْ
المَطعَمُ مِن أَفضَلِ المَطَاعِمِ الَّتِي زُرتُها	الْمَطْعَم مِنْ اَفْضَلْ المَطَاعِم الْتِي زَرْتْهَا
تَعَامُلَكُم كَانَ رَائِعًا	تَعَامْلْكُمْ كَان رَايَعَا
مُوَظَّفُ الاستِقبَالِ كَانَ لَطِيفًا	مَوَظَفْ الْاِسْتِقْبَال كَان لَطِيفَا
هَذَا المَطعَمُ غَيرُ مُرِيح	هَذا الْمَطْعِم غِيْرْ مَرِيحْ
صَوتُ المُوسِيقَى مُرتَفِعٌ جِدًّا	صَوْتْ الْمُوسِيقَى مَرْتَفْعْ جِدَا
الجَوُّ رَائِعٌ دَاخِلَ المَطعَم	الجَوْ رَايْعْ دَاخِل الْمَطْعِمْ
أُحِبُّ هَذَا المَطعَم	اَحَبّ هَذَا الْمَطْعِم
رَائِحَةُ الدُخَّانِ مُزعِجَة	رَايْحَة الْدِّخَانْ مَزْعَجَة
مُمتَاز	مِمْتَاز
مُتَوَسِّط	مَتْوَسَطْ
رَائِع	رَايَعْ
غَيرُ جَيِّد	غِيْرْ جِيْدْ
غَيرُ مُرضِي	غِير مَرْضِي
غَيرُ مُرِيح	غِيْرْ مَرِيحْ
أَينَ دَورَاتُ المِيَاه	اَيْنْ دَوْرَاتْ الْمِيَاه
أَينَ دَورَةُ المِيَاه	اَيْن دَوْرَة الْمِيَاهْ
أُرِيدُ دَورَةَ المِيَاه	اَرِيدْ دُورَة الْمِيَاهْ
أَينَ يُمكِنُ أَن أَغسِلَ يَدِي	اَيْن يُمْكِنْ اَنْ اَغْسَلْ يِدِي
أُرِيدُ أَن آخُذَ الأَكلَ خَارِجَ المَطعَم	اَرِيدْ اَنْ اَخَذْ الاَكْل خَارِجْ الْمَطْعَمْ
هَل يُمكِنُ أَن آخُذَ هَذَا خَارِجَ المَطعَم	هَلْ يُمْكِنْ اَنْ اَخَذْ هَذَّا خَارِجْ الْمَطْعَمْ
تَفَضَّلِ الطَّلَب	تَفْضِلْ الطَّلَب
سَآخُذُ المُتَبَقِّي مِن الطَّعَامِ مَعِي	سَاخِذ الْمَتْبَقِي مِنْ الطَعَامْ مَعِي
أُرِيدُ طَاوِلَةً لِشَخصَين	اَرِيدْ طَاوْلَة لِشْخْصِينْ
أَنَا حَاجِز	اَنَا حَاجِزْ
لَدَيَّ حَجزٌ فِي المَطعَم	لِدِي حَجْزْ فِي الْمَطْعِمْ
أُرِيدُ طَاوِلَةً لأربَعَةِ أَشخَاص	اَرِيدْ طَاوِلَة لِارْبَعَة اَشْخَاصْ
أُرِيدُ طَاوِلَةً لِثَلاثَةِ أَشخَاص	اَرِيدْ طَاوِلَة لِثْلَاثَة اَشْخَاصْ
مِندِيل	مِنْدِيلْ
مَنَادِيل	مَنَادِيلْ
صُحُون	صَحونْ
صَحنٌ كَبِير	صَحْنْ كْبِيرْ
صَحنٌ صَغِير	صَحِنْ صَغِيرْ
مِلعَقَة	مِلْعَقَة
مِلعَقَةٌ كَبِيرَة	مَلْعَقَة كَبِيرَة
مِلعَقَةٌ صَغِيرَة	مِلْعَقَة صَغِيرَة
مِندِيلٌ للتَّمسِيح	مِنْدِيلْ لِلْتَمْسِيح
أَطبَاق	اَطْبَاقْ
طَبَق	طَبْقَ
كَأس	كَاسْ
ثَلاثَةَ صُحُون	ثَلَاثَة صَحونْ
مِلعَقَتَين	مَلْعَقْتِينْ
صَحنٌ كَبِيرٌ وَمِلعَقَة	صَحْنْ كْبِير وَمْلْعَقَة
طَاوِلَةٌ كَبِيرَة	طَاوْلَة كَبِيرَة
طَاوِلَةٌ صَغِيرَة	طَاوِلَة صَغِيرَة
أَحضِرِي الفَاتُوَرة	اَحْضِرِي الْفَاتُورَة
أُرِيدُ الفَاتُورَة	اَرِيدْ الفَاتُورَة
أَينَ الفَاتُورَة	اَيْنْ الْفَاتُورَة
أَينَ فَاتُورَةَ الطَّعَام	اَيْنْ فَاتُورَة الطَّعَامْ
فَاتُورَةٌ لِكُلِّ شَخصٍ لَو سَمَحت	فَاتُورَة لكلْ شَخْصْ لُو سَمْحَتْ
مُمكِنُ الإِيصَال لَو سَمَحتِي	مُمْكِنْ الْاَيْصَال لُو سَمْحْتِي
هُنَاكَ خَطَأٌ فِي الفَاتُورَة	هَنَاكْ خَطَّا فِي الفَاتورَة
أَينَ الفَاتُورَةُ بِالتَّفصِيل	اَيْنْ الْفَاتُورَة بِالتَّفْصِيل
لَم أَطلُب هَذَا	لَمْ اَطْلِبْ هَذَا
مَا طَلَبتُ هَذَا الصِّنف	مَا طَلْبْتْ هَذَّا الصَّنْفْ
اِحتَفِظ بِالبَاقِي	اَحْتَفِظْ بِالْبَاقِي
بِكَم قِيمَةُ الغَدَاء	بِكُمْ قِيمَة الغَدَاء
كَم إجمَالي القِيمَة	كُمْ اَجْمَالِي الْقِيْمَة
كَم سِعرُ العَشَاء	كُمْ سَعْرْ الْعَشَاء
بِكَم قِيمَةُ البُوفِيهِ المَفتُوح	بِكُمْ قِيْمَة الْبُوفِيه الْمَفْتُوح
هَل هُنَاكَ رُسُومُ لِلخِدمَة	هَلْ هُنَاكْ رَسومْ لِلْخِدْمَة
هَل تَعمَلُونَ يَومَ الخَمِيس	هَلْ تَعْمِلُونْ يوم الْخَمِيسْ
هَل يَفتَحُ المَطعَمُ يَومَ الجُمُعَة	هَلْ يِفْتَحْ الْمَطْعَم يُوم الجُمْعَة
السَّلَامُ عَلَيكُم وَرَحمَةُ اللهِ وَبَرَكَاتُه	السَّلَامْ عَلَيْكُمْ وَرْحَمَة الله وَبْرَكَاته
السَّلَامُ عَلَيكُم	السَلَامْ عَلِيْكُم
السَّلَامُ عَلَيكُم وَرَحمَةُ الله	السَّلَام عَلَيْكُمْ وَرَحَمَة الله
مَسَاءُ الخَير	مَسَاءْ الْخَيْر
صَبَاحُ الخَير	صَبَاح الْخَيْر
مَسَاءُ الخَيرَات	مَسَاء الخَيْرَاتْ
أَنَا حَاجِز	اَنَا حَاجِزْ
لَدَيَّ حَجزٌ فِي هَذَا الفُندُق	لِدِي حَجْزْ فِي هَذا الْفَنْدِقْ
حَجَزتُ الغُرفَةَ رَقم	حَجْزَت الغُرْفَة رَقَمْ
غُرفَتِي رَقم	غَرَفتِي رَقَمْ
غُرفَةٌ لِشَخصٍ وَاحِد	غُرْفَة لِشَخْصْ وَاحِد
غُرفَةٌ لِشَخصَين	غُرْفَة لِشْخْصينْ
غُرفَةٌ لِثَلاثَةِ أَشخَاص	غُرْفَة لِثْلَاثَة اَشْخَاصْ
أُرِيدُ غُرفَةً لِشَخصٍ وَاحِد	اَرِيدْ غُرْفَة لِشْخْصْ وَاحِد
أُرِيدُ جَنَاحًا عَائِلِيًا	اَرِيدْ جْنَاحَا عَايْلِيَا
أَبحَثُ عَن شُقَّة	اِبْحَثْ عَنْ شَقَة
غُرفَةٌ بِسَرِيرٍ مُزدَوَج	غُرْفَة بِسْرِير مَزْدَوج
غُرفَةٌ بِسَرِيرَين	غُرْفَة بِسْرِيرِين
جَنَاحٌ خَاصٌّ مَعَ دَورَتَي مِيَاه	جَنَاح خَاصْ مَعْ دُورَتِي مِيَاهْ
ثَلاثُ دَورَاتِ مِيَاه	ثَلَاث دَوْرَاتْ مِيَاهْ
أَربَعُ دَورَاتِ مِيَاه	اَرْبَعْ دوْرَاتْ مِيَاه
جَنَاحٌ خَاصٌّ مَعَ مَجلِسٍ وغُرفَةٌ لِاستِقبَالِ الضُّيُوف	جِنَاحْ خَاصْ مَعْ مَجْلِسْ وْغُرْفَة لِاسْتِقْبَال الضِيوفْ
ثَلاثُ غُرَفِ نَومٍ مَعَ دَورَتَي مِيَاه	ثَلَاثْ غَرْفْ نُومْ مَعْ دُورْتِي مِيَاه
غُرفَتَا نَومٍ مَعَ دَورَةِ مِيَاه	غَرْفَتَا نُومْ مَعْ دُوْرَة مِيَاهْ
الصَّوتُ غَيرُ وَاضِح	الصوْتْ غَيْرْ وَاضِح
لا أَسمَعُك	لَا اِسْمَعَكْ
لا أَستَطِيعُ سَمَاعَ صَوتِك	لَا اِسْتَطِيعْ سْمَاعْ صُوتَكْ
أُرِيدُ التَّحَدُّثَ مَعَ المَسئُول	اَرِيدْ التَّحْدِثْ مَعْ الْمَسْيول
أُرِيدُ التَّحَدُّثَ مَعَ شَخصٍ آَخَر	اَرِيدْ الْتَحَدِثْ مَعْ شَخْصْ اَخْر
آمُلُ التَّصحِيح	اَمَلْ التَّصْحِيح
أَرجُو التَّعدِيل	اَرْجُو الْتَعْدِيلْ
أَبحَثُ عَن فُندُق	اَبْحَثْ عِنْ فِنْدَقْ
أَنَا أَبحَثُ عَن فُندُق	اَنَا اَبْحَثْ عَنْ فَنْدِقْ
هَل تُسَاعِدُنِي فِي البَحثِ عَن فُندُق	هَلْ تَسَاعِدْنِي فِي الْبَحْثْ عِنْ فَنْدِق
أَرجُو أَن تُعِيدَ عَلَيَّ المَعلُومَاتَ الّتِي ذَكَرتُهَا	اَرْجُو اَنْ تَعِيدْ عَلِي الْمَعْلُومَاتْ التِي ذَكْرْتَهَا
لا تَفهَمُ مَا أَقُول	لَا تَفْهَمْ مَا اَقول
لَم تَفهم مَا أُرِيد	لَم تَفْهَم مَا ارِيدْ
لَم تَفهَمِينِي	لَمْ تَفْهَمِينِي
لا أَفهَمُ مَا تَقُولِين	لَا اَفْهَمْ مَا تَقولِينْ
لا تَفهَمِينَ مَا أَقُول	لَا تَفْهَمِينْ مَا اَقول
لَم تَفهَمِي مَا أُرِيد	لَمْ تَفْهَمِي مَا ارِيدْ
لَم تَفهَمِينِي	لَم تَفْهَمِينِي
جَنَاح	جَنَاحْ
شُقَّة	شَقَّة
غُرفَة	غُرَّفَة
غُرفَتَين	غَرْفَتِينْ
ثّلاثُ غُرَف	ثَلَاثْ غَرَفْ
حَمَّام	حَمَامْ
دَورَةُ مِيَاه	دورَة مِيَاه
مَطبَخ	مَطَبَخْ
صَالَة	صَالَة
مَمَر	مَمَّرْ
سَرِير	سَرِيرْ
طَاوِلَة	طَاوِلَة
أُرِيدُ خَدَمَاتَ غَسِيلِ المَلَابِس	اَرِيدْ خَدَمَاتْ غَسِيلْ الْمَلَابِس
تَحوِيلَةُ مِغسَلَةِ المَلابِس	تَحَوِيلَة مَغْسِلَة الْمَلَابِس
خَدَمَاتُ تَنظِيفِ الغُرَف	خَدَمَاتْ تَنْظِيف الغَرَف
مَسئُولُ تَنظِيفِ الغُرَف	مَسِيولْ تَنْظِيفْ الغَرَفْ
أُرِيدُ أَن تُنَظَّفَ الغُرفَة	اَرِيدْ اَنْ تَنْظِفْ الْغُرْفَة
تَحوِيلَة نَظَافَةَ الغُرَف	تَحْوِيلَة نِظَافَة الْغَرَفْ
كَم رَقمُ تَحوِيلَة	كُمْ رَقَمْ تَحْوِيلَة
هَل تُعطِينِي رَقمَ تَحوِيلَةُ مِغسَلَةُ المَلابِس	هَلْ تَعْطِينِي رَقَّمْ تَحْوِيلَة مَغْسَلَّة الْمَلَابِس
أُرِيدُ رَقمَ تَحوِيلَةَ خَدَمَاتِ الغُرَف	اَرِيدْ رَقَمْ تَحْوِيلَة خَدْمَاتْ الغُرَفْ
مَن هُوَ المَسئُولُ عَن	مِنْ هُو الْمَسْيول عَنْ
مَن المَسئُولُ عَن	مِنْ الْمَسْيولْ عَنْ
خَدَمَاتُ الغَسِيل	خَدَمَاتْ الْغَسِيلْ
الغَسَّالَة	الْغَسَالَة
مِغسَلَةُ المَلَابِس	مَغْسِلَة الْمَلَابِسْ
المَطعَم	الْمَطَعَم
البَنك	الْبَنْكْ
السُّوق	السُّوقْ
السُّوبَر مَاركِت	السُّوبْر مَارْكَتْ
دَورَةُ المِيَاه	دورَةْ الْمَيَاهْ
الحَمَّام	الْحَمَام
خَدَمَاتُ الغُرَف	خَدَمَاتْ الْغَرَفْ
هَل يُوجَدُ حَمَّامَ جَاكُوزِي	هَلْ يوجَدْ حَمَام جَاكُوزِي
هَل هُنَاكَ حَمَّامُ بُخَار	هَلْ هُنَاك حَمَام بِخَارْ
أُرِيدُ حَمَّامَ بُخَار	اَرِيدْ حَمَام بِخَارْ
هَل يُوجَدُ مَسبَحٌ فِي الفُندُق	هَلْ يوجِدْ مَسْبَحْ فِي الْفَنْدِقْ
مِن فَضلِكَ أَينَ المَسبَح	مِنْ فَضْلَكْ اَيْن الْمَسْبَحْ
أُرِيدُ أَن أَسبَح	اَرِيدْ اَنْ اَسْبَحَ
أَينَ حَمَّامَ السِّبَاحَة	اَيْنْ حَمَامْ الْسَبَاحَة
هَل هُنَاكَ مَسبَحٌ خَاصٌّ بالأَطفَال	هَلْ هُنَاكْ مَسْبَحْ خَاصْ بِالْاَطْفَال
مَسَابِحٌ لِلأَطفَال	مَسَابِحْ لِلْاَطْفَال
مَاهِيَ المَطَاعِمُ المَوجُودَةُ فِي الفُندُق	مَاهِي الْمَطَاعِم الْمَوْجُودَة فِي الْفَنْدِقْ
هَل يُوجَدُ مَطعَمٌ بَحرِي	هَلْ يوجِدْ مَطْعَمْ بِحْري
مَطَاعِمٌ صِينِيَّة	مَطَاعِمْ صَيْنِيَّة
مَطَاعِمٌ لِلأَكلِ الحَلَال	مَطَاعِمْ لِلْاَكِل الْحَلَال
هَل جَمِيعُ الأَصنَافِ حَلَال	هَلْ جَمِيعْ الْاَصْنَاف حَلَال
هَل هُنَاكَ مَركَزٌ للتَّسَوّقِ دَاخِلَ الفُندُق	هَلْ هُنَاك مَرْكِزْ لِلْتسَوق دَاخِل الْفَنْدِقْ
مَا هُوَ أَقرَبُ مَركَزٍ للتَّسَوُّق	مَا هُو اَقْرَبْ مَرْكَزْ لِلْتَّسَوقْ
مَرَاكِزُ للتَّسوِيقِ قَرِيبَةٌ مِن الفُندُق	مَرَاكِزْ لِلْتّسْوِيقْ قَرِيبَة مِنْ الْفِنْدَقْ
مَا هُوَ أَقرَبُ مَرَاكِزَ التَّسَوُّقِ لِلفُندُق	مَا هُو اِقْرَبْ مَرَاكِز التَّسْوُّقْ لِلْفَنْدَقْ
أَقرَبُ المَطَاعِمَ لِلفُندُق	اَقْرَبْ المَطَاعِمْ لِلْفَنْدِقْ
هَل يُوَجُد صَرَّافٌ آلِي	هَلْ يوجِدْ صْرَافْ اِلْي
أُرِيدُ صَرَّافاً آليا	اَرِيدْ صَرَافَا اليا
هَل يُوجَدُ لَدَيكُم مَسَاج	هَلْ يوجِدْ لَدِيكُمْ مَسَاج
مَسَاجُ لِلظَّهَر	مَسَاج لِلْظَّهْرْ
أُرِيدُ المَسَاج	اَرِيدْ الْمَسَاج
مَسَاج	مَسَاج
مَسبَح	مَسَبَحْ
قَاعَة	قاعَة
فُندُق	فِنْدَقْ
صَرَّاف	صَرَاف
حَدِيقَة	حَدِيقَة
بَهو	بَهُو
مَركَزُ تَسَوُّق	مَرْكَزْ تَسوْق
حَدِيقَةٌ عَامَّة	حَدِيقَة عَامَة
بِكَم اللَّيلَةُ الوَاحِدَة	بِكُمْ الْلِيلَة الْوَاحْدَة
كَم إِجمَالِيُّ الفَاتُورَة	كمْ اِجْمَالِي الفَاتُورَة
إِجمَالِيُّ الإِقَامَة	اَجْمَالِي الْاَقَامَة
أَعطِنِي الفَاتُورَةَ مِن فَضلِك	اَعْطِنِي الْفَاتُورَة مِنْ فِضْلَكْ
هَل مُمكِن أَن أَدفَعَ نَقدًا	هَلْ مُمْكِنْ اَنْ اَدْفَعْ نَقْدَا
أُرِيدُ أَن أَدفَعَ نَقدًا	اَرِيدْ اَنْ اَدْفَعْ نَقْدَا
هَل تَقَبلَونَ الشَّيكَات	هَلْ تَقْبِلُونْ الشِّيْكَات
هَل أَستَطِيعُ أَن أَدفَع بِشَيك	هَلْ اَسْتَطِيعْ اِنْ اِدْفَعْ بِشِيكْ
شَيكٌ مُصَدَّق	شِيكْ مَصْدَقْ
سَأَدفَعُ بِالبِطَاقَةِ الائتِمَانِيَّة	سَادْفَعْ بِالْبْطَاقَة الْاَيْتِمَانِيَة
سَأُحَاسِبُ بِالفِيزا	سَاحَاسِبْ بِالفِيزَا
هَل يَشمَلُ هَذَا كُلُّ مَصَارِيفَ الإِقَامَة	هَلْ يِشْمِلْ هَذا كُلْ مَصَارِيف الْاَقَامَة
هَل أَضَفتَ قِيمَةَ الوَجَبَات	هَلْ اَضْفَتْ قِيْمَة الوَجْبَاتْ
أُرِيدُ فَاتُورَةً مُستَقِلَّة	اَرِيدْ فَاتُورَة مَسْتَقَلَة
فَوَاتِيرُ مُستَقِلَّة	فوَاتِيرْ مَسْتَقَلَة
أُرِيدُ الإِيصَالَ لَو سَمَحت	اَرِيدْ الاَيْصَال لو سَمَحْتْ
مِن فَضلِكَ أَعطِنِي الفَوَاتِيرَ كَامِلَة	مِنْ فِضْلِكْ اَعْطِنِي الْفُوَاتِير كَامْلَة
أَعطِنِي الإِيصَال	اَعْطِنِي الْاَيْصَال
فَاتُورَة	فَاتُورَة
شَيك	شِيكْ
نَقد	نَقَدْ
صَرَّاف	صَرَاف
بِطَاقَة	بِطَاقَة
نَقدًا	نَقْدَا
مَاستَر كَارد	مَاسْتِرْ كَارْدْ
فِيزا كَارد	فِيزَا كَارِدْ
مَاستَر كَارد	مَاسْتَر كَارْدْ
أَمرِيكَان إِكسِبرِس	امْرِيكَان اكسبرِس
فِيزَا دِبِت	فِيزَا دَبْتْ
إِيصَال	اَيْصَال
جَدوَلُ مَوَاعِيدِ الرَّحَلات	جَدوَّل مَوَاعِيْدْ الرَحْلَاتْ
أَرغَبُ فِي مَعرِفَةِ مَوَاعِيدِ رَحَلاتِ المُغَادَرَة	اَرْغَبْ فِي مَعْرَفَة مَوَاعِيْدْ رَحَلَاتْ الْمَغَادِرَة
أَرغَبُ فِي السَّفَرِ مِن الرِّيَاضِ إِلى	اَرْغَبْ فِي السَفْرْ مِنْ الرِيَاضْ اِلَى
أَرغَبُ فِي السَّفَرِ مِن	اَرْغَبْ فِي السَّفْرْ مِنْ
أَرغَبُ فِي السَّفَرِ إلى	اَرْغَبْ فِي السَّفْر اَلَى
مَتَى تَصِلُ الرِّحلَة	مَتَى تَصْلْ الرِّحْلَة
كَم عَدَدُ الرَّحَلاتِ القَادِمَةِ مِن	كُمْ عَدَدْ الرَحْلَاتْ الْقَادِمَة مِنْ
كَم عَدَدُ الرَّحَلاتِ المُغَادِرَةِ مِن	كَمْ عَدَدْ الرَحْلَاتْ الْمُغَادِرَة مِنْ
أَرغَبُ فِي مَعرِفَةِ مَوَاعِيدِ رَحَلَاتِ المُغَادَرَة	اَرْغَبْ فِي مَعْرَفَة مَوَاعِيدْ رَحَلَاتْ المَغَادِرَة
أَرغَبُ فِي مَعرِفَةِ مَوعِدِ رِحلَةِ جُدَّة	اَرْغَبْ فِي مَعْرِفَة مَوَعْدْ رَحْلَة جِدَة
مَتَى تَصِلُ الرِّحلَةُ رَقمُ وَاحِد اِثنَين ثَلاثَة	مَتّى تَصْل الْرِّحْلَة رَقَمْ وَاحِد اِثْنِينْ ثْلَاثَة
مَوعِدُ وُصُولِ الرِّحلَةِ رَقم	مَوَعْدْ وَصولْ الرِّحْلَة رَقَمْ
مَوعِدُ وُصُولِ الرِّحلَةِ رَقم ثَلاثَة اِثنَين وَاحِد	مَوَعْدْ وَصولْ الْرِّحْلَة رَقَمْ ثْلَاثَة اِثْنِينْ وَاحِد
أَرجُو التَّعدِيل	اَرْجُو الْتَعْدِيل
عَدِّلِ الحَجزَ مِن فَضلِك	عَدْلْ الْحَجْزْ مِنْ فَضْلَكْ
غَيِّر مَوعِدَ الحَجزِ إلى	غَيْرْ مَوَعْدْ الْحَجْزْ الْى
رَقمُ الحَجزِ هو	رَقَّمْ الْحَجْزْ هُو
أَرجُو أَن تُعِيدَ عَلَيَّ المَعلُومَاتِ الّتِي ذَكَرتَها	اِرْجُو اَنْ تَعِيدْ عَلِيْ الْمَعْلُومَاتْ التِي ذَكْرْتَهَا
أُرِيدُ التَّحَدُّثَ مَعَ المَسئُول	اَرِيدْ الْتَّحْدِثْ مَعْ الْمَسْيول
أُرِيدُ التَّحَدُّثَ مَعَ شَخصٍ آخَر	اَرِيدْ الْتَحْدِثْ مَعْ شَخْصْ اَخْر
أُرِيدُ السَّفَرَ إِلَى	اَرِيدْ السَّفْرْ اِلَى
أُرِيدُ إِلغَاءَ الحَجز	اَرِيدْ الغَاءْ الْحَجْزْ
الحَجزُ غَيرُ مُنَاسِب	الْحَجْزْ غِيْرْ مَنَاسِبْ
أُرِيدُ دَفعُ ثمَنَ التَّذكِرَة	اَرِيدْ دَفْعْ ثَمْنْ التَّذْكْرَة
كَم مَجمُوُع ثَمَنِ التَّذَاكِر	كُمْ مَجْمُوعْ ثَمَنْ التَّذَاكُرْ
مَجمُوعُ الثَّمَن	مَجْمُوعْ الْثَمْنْ
كَمِ السِّعرَ الإجمَالي	كُمْ السَعْرْ الْاَجْمَالِي
أُرِيدُ دَفعَ قِيمَةَ التَّذكِرَةِ الآن	اَرِيدْ دَفْعْ قِيْمَة الْتَّذْكْرَة الْاَنْ
سَأَدفَعُ بِالبِطَاقَةِ الائتِمَانِيَّة	سَادْفَعْ بِالْبْطَاقَة الْاَيْتِمَانِيَة
رَقمُ التَّذكِرَةِ الإلِكتُرونِيَّةِ هُو	رَقَمْ التَّذْكْرَة الْاِلْكَتْرُونِيَة هُو
مَاهُوَ رَقمُ التَّذكِرَةِ الإلِكتُرونِيَّة	مَاهُو رَقَمْ الْتَّذْكْرَة الْاِلْكَتْرُونِيَة
اِطبَع كَرتَ الصُّعُودِ لِلطَّائِرَة	اَطْبَعْ كُرْتْ الصُعودْ لِلْطَايِرَة
أُرِيدُ أَن تُصدِرَ كَرتَ الصُّعُود	اَرِيدْ اَنْ تَصْدِرْ كُرْتْ الصعودْ
غَيِّرِ المَقَاعِدَ مِن فَضلِك	غَيْرْ الْمَقَاعِدْ مِنْ فَضْلَكْ
أُرِيدُ تَغيِيرَ المَقَاعِد	اَرِيدْ تَغْيِير الْمَقَاعِد
هَل تَستَطِيعُ تَأكِيدَ هَذَا الحَجز	هَلْ تَسْتَطِيع تَاكِيدْ هَذَا الْحَجْزْ
بِجَانِبِ النَّافِذَة	بِجَانِبْ الْنَّافِذَة
عَلَى المَمَر	عَلَى الْمَمْرْ
بِقُربِ مَخرَجِ الطَّوَارِئ	بِقُرْبْ مَخْرَجْ الطَّوَارِي
حَجز	حَجَزْ
تَذكِرَة	تَذْكَرَة
كَرتُ صُعُود	كرت صَعُودْ
رَقم	رَقْمْ
نَافِذَة	نَافْذَة
الرِّحلَة	الرحْلَة
كَم رَقمُ بَوَّابَةِ الدُّخُول	كُمْ رَقَّمْ بِوَابَة الدُّخُول
أُرِيدُ مَعرِفَةَ رَقمِ البَوَّابَة	اَرِيدْ مَعْرِفَة رَقَمْ الْبُوَابَة
رَقمُ الحَجزِ مِن فَضلِك	رَقَمْ الْحَجْزْ مِنْ فَضْلَكْ
أُرِيدُ رَقمَ الحَجز	اَرِيدْ رَقَمْ الْحَجْزْ
أُرِيدُ مَعرِفَةَ رَقمَ الحَجز	اَرِيدْ مَعْرِفَة رَقَمْ الْحَجْزْ
أُرِيدُ مَعرِفَةَ رَقمَ الرِّحلَة	اَرِيدْ مَعْرَفَة رَقْمْ الرِّحْلَة
أُرِيدُ مَعرِفَةَ رَقمَ الصَّالَة	اَرِيدْ مَعْرِفَة رَقَمْ الْصَالَة
أُرِيدُ تَأكِيدَ الحَجز	اَرِيدْ تَاكِيدْ الْحَجْزْ
أُرِيدُ مَعرِفَةَ وَقتَ الرِّحلَة	اَرِيدْ مَعْرِفَة وَقْتْ الرِّحْلَة
أُرِيدُ مَعرِفَةَ وَقتَ وُصُولِ الرِّحلَة	اَرِيدْ مَعْرَفَة وَقْتْ وَصولْ الرِّحْلَة
الصَّوتُ غَيرُ وَاضِح	الصوْتْ غَيْرْ وَاضِح
لا أَسمَعُك	لَا اِسْمَعَكْ
لا أَستَطِيعُ سَمَاعَ صَوتِك	لَا اِسْتَطِيع سْمَاعْ صُوتَكْ
صَوتُكَ مُنخَفِض	صوْتِكْ مَنْخَفِضْ
حَجزٌ جَدِيدٌ مِن فَضلِك	حَجْزْ جَدِيدْ مِنْ فَضْلَكْ
أُرِيدُ مَعرِفَةَ وَقتَ مُغَادَرَةِ الرِّحلَة	اَرِيدْ مَعْرَفَة وَقْتْ مَغَادِرَة الرَحْلَة
هَل تَأَخَّرَتِ الرِّحلَة	هَلْ تَاخَرْتْ الرَّحْلَة
هَل سَتُقلِعُ الطًّائِرَةَ فِي مَوعِدِها	هَلْ سَتْقَلَع الْطَايِرَة فِي مَوْعْدَهَا
الرِّحلَةُ فِي مَوعِدِها	الرحْلَة فِي مَوْعْدَهَا
تَأَخَّرَتِ الرِّحلَةُ سَاعَتَين	تَاخَرْتْ الرَّحْلَة سَاعَتِينْ
الصَّالَةُ المَحَلِيَّة	الصَالَة الْمَحَلِيَّة
الصَّالَةُ الدَّاخِلِيَّة	الصَالَة الْدَاخْلِيَة
الصَّالَةُ الدَّولِيَّة	الصَالَة الدُولِيَة
الصَّالاتُ الدَّولِيَّة	الصَالَات الدُّولِيَة
صَالَةُ المُغَادَرَة	صَالَة الْمَغَادِرَة
صَالَةُ القُدُوم	صَالَة الْقُدُوم
صَالاتُ الخُطُوطِ الأَجنَبِيَّة	صَالَاتْ الخَطُوط الْاَجْنِبِيَة
الخُطُوطُ الأَجنَبِيَّة	الْخَطوطْ الْاَجْنَبِية
هَذِهِ الأَمتِعَةُ الخَاصَّةُ بِي	هَذِهْ الْاِمْتَعَة الْخَاصَة بِي
هَذِهِ أَمتِعَتِي	هَذِهْ اِمْتَعْتِي
سَبعَةُ قِطَع	سَبْعَة قَطَّعْ
خَمسَةُ قِطَع	خَمْسَة قَطَّعْ
عَرَبَةُ أَطفَال	عَرَبَة اَطْفَالْ
نَعَم هَذِهِ القِطعَةُ لي	نَعَمْ هَذِهْ الْقَطْعَة لِي
نَعَم أَنَا أَبحَثُ عَن هَذِهِ القِطعَة	نَعَمْ اَنَا اَبْحَثْ عِنْ هَذِه الْقَطَعَة
مَكَانُ سَيَّارَاتِ الأُجرَةِ مِن فَضلِك	مَكَان سَيَّارَات الْاَجْرَة مِنْ فَضْلَكْ
سّيَّارَاتُ الأُجرَة	سَيَارَات الْاَجْرَة
سّيَّارَةُ الأُجرَة	سَيَارَة الْاَجْرَة
أَينَ الطَّرِيقُ إِلَى فُندُقِ المَطَار	اَيْنْ الطَرِيقْ اِلَى فِنْدَقْ المَطَارْ
أَقرَبُ فُندُق	اَقْرَبْ فِنْدَقْ
صَالَة	صَالَة
صَالَات	صَالَاتْ
رِحلَة	رَحَلَة
أَمتِعَة	اِمْتَعَة
كَرتَ الصُّعُود	كَرْت الصَّعودْ
أَبحَثُ عَن مُجَمَّعِ أَسوَاق	اَبْحَثْ عِنْ مَجْمَعْ اَسْوَاقْ
أَنَا أَبحَثُ عَن	اَنَا اَبْحَثْ عِنْ
أَحتَاجُ إِلَى مُسَاعَدَة	اَحْتَاجْ اِلَى مَسَاعَدَة
أَنَا مُحتَاجٌ إِلَى مُسَاعَدَتِك	اَنَا مَحْتَاجْ اِلَى مَسَاعَدَتَكْ
أَحتَاجُ لِتَاكسِي	اَحْتَاجْ لِتَاكْسِي
هَل تَستَطِيعُ إِسعَافِي	هَلْ تَسْتَطِيع اِسْعَافِي
أَحتَاجُ لِسَيَّارَةِ أُجرَة	اَحْتَاجْ لِسَيَّارَة اَجْرَة
أُرِيدُ مَوقِعَ سَيَّارَاتِ الأُجرَة	اَرِيدْ مَوْقَعْ سَيَارَات الْاَجْرَة
مَاهُوَ أَقرَبُ مُستَشفَى	مَاهُو اَقْرَبْ مَسْتَشَفَى
أَنَا أَبحَثُ عَن شَارِع	اَنَا اَبْحَثْ عَنْ شَارَعْ
أَبحَثُ عَن أَقرَبِ مَركَزٍ صِحِّي	اَبْحَثْ عِنْ اَقْرَبْ مَرْكِزْ صَحِي
أَحتَاجُ لِعِلَاج	اَحْتَاجْ لَعْلَاجْ
أَحتَاجُ للشُّرطَة	اَحْتَاجْ لِلْشُرْطَة
أَنَا مُحتَاجٌ لِلشُّرطَة	اَنَا مَحْتَاج لِلْشرْطَة
أَحتَاجُ لِلِيمُوزِين	اَحْتَاجْ لِلِيمُوزِين
أَحتَاجُ لِمُسَاَعَدة	اَحْتَاج لِمْسَاعَدَة
أَحتَاجُ تَاكسِي	اَحْتَاجْ تَاكْسِي
كَم المَسَافَةُ مِن الرِّيَاضِ إلَى مَكَّة	كُمْ الْمَسَافَة مِنْ الرِيَاضْ اِلَى مَكَّة
تَاكسِي كَبِير مِن فَضلِك	تَاكْسِي كْبِيرْ مِنْ فَضْلِكْ
أَحتَاجُ لِوَسِيلَةِ نَقل	اَحْتَاجْ لُوسِيلَة نَقُلْ
أُرِيدُ مَعرِفَةَ حَرَكَةَ السَّير	اَرِيدْ مَعْرَفَة حَرَكَة الْسِيْر
هَل يُوجَدُ ازدِحَامٌ مُرُورِي	هَلْ يوجَدْ اِزْدِحَامْ مُرورِي
كَمِ السَّاعَةُ الآن	كُمْ الْسَاعَة الَاَنْ
كَم سِعرَ صَرف	كمْ سَعْرْ صَرْفْ
مَا هُوَ العُنوَان	مَا هُو الْعُنوَان
مَا هُوَ عُنوَان	مَا هُو عَنْوَان
هَل مُمكِن أَن تُعطِيَنِي العُنوَان	هَلْ مُمْكِنْ اَنْ تَعْطِينِي الْعُنوَانْ
مَا هُوَ أَقرَبُ طَرِيقٍ إِلَى	مَا هُو اَقْرَبْ طَرِيقْ اِلْى
هَل أَستَطِيعُ الاتِّصَالَ ب	هَلْ اَسْتَطِيعْ الْاَتْصَال بِ
كَيفَ أَستَطِيعُ الاتِّصَال	كِيفْ اِسْتَطِيعْ الْاَتْصَال
مَا هُوَ مِفتَاحُ الَّدولَة	مَا هُو مِفْتَاحْ الْدَّوْلة
مَا هُوَ مِفتَاحُ المَدِينَة	مَا هُو مِفْتَاحْ الْمَدِينَة
مَا هِيَ حَالَةُ الطَّقسِ فِي مَكَّة	مَا هِي حَالَة الطَّقْسْ فِي مَكَّة
مَا هِيَ حَالَةُ الطَّقسِ فِي الرِّيَاض	مَا هِي حَالَة الطَّقْسْ فِي الرِيَاضْ
مَا هِيَ حَالَةُ الطَّقسِ فِي	مَا هِي حَالَة الْطَّقْسْ فِي
كَم مَسَافَةُ السَّيرِ إِلَى	كُمْ مَسَافَة الْسِيْر اَلَى
كَم دَرَجَةُ الحَرَارَةِ الآن	كُمْ دَرَجَة الْحَرارَة الْاِنْ
أَقرَبُ صَيدَلِيَّةٍ لَو سَمَحت	اَقْرَبْ صَيْدَلِيَة لو سَمْحَتْ
مَتَى تُشرِقُ الشَّمس	مَتَى تَشْرَقْ الْشَّمْس
مَتَى تَغرُبُ الشَّمس	مَتَى تَغْرَبْ الشَّمْسْ
الرِّيَال	الرِيَالْ
الدُّولَار	الدُّولَارْ
الجُنِيه	الْجَنِيهْ
اللَّيرَة	الْلِيرَة
الدِّرهَم	الدرْهُمْ
رِيَال	رِيَال
دُولَار	دولَارْ
جُنَيه	جَنِيهْ
لِيرَه	لِيْرَهْ
دِرهَم	دَرْهَمْ
تَاكسِي	تَاكْسِي
شَارِع	شَارِعْ
طَرِيق	طَرِيقْ
مَسَافَة	مَسَافَة
أُرِيدُ مَطعَم	اَرِيدْ مَطْعَمْ
أَينَ مُجَمَّعُ المَطَاعِم	اَيْن مَجْمَعْ الْمَطَاعُمْ
مَا هُوَ أَقرَبُ المَطَاعِم	مَا هُو اِقْرَبْ الْمَطَاعِمْ
أُرِيدُ الاستِعلامَ عَن بِضَاعَة	اَرِيدْ الْاِسْتَعْلَام عَنْ بِضَاعَة
بِكَم هَذِهِ القِطعَة	بِكُمْ هَذْهْ الْقَطْعَة
بِكَم هَذِه	بِكُمْ هَذَهْ
كَم ثمَنُ هَذِه	كمْ ثَمَنْ هَذِه
كَم سِعرُ هَذَا	كُمْ سَعْرْ هَذَا
كَم ثَمَنُ هَذَا	كَمْ ثَمْنْ هَذَّا
كَم سِعرُ هَذِهِ القِطعَة	كمْ سَعْرْ هَذِهْ الْقَطْعَة
أُرِيدُ الاستِعلامُ عَن تَكَالِيف	اَرِيدْ الْاِسْتَعْلَام عَنْ تَكَالِيفْ
أُرِيدُ الاستِعلامُ عَن فَاتُورِة	اَرِيدْ الْاسْتَعْلَام عَنْ فَاتورَة
أُرِيدُ التَّأَكُّدَ مِن صِحَّةِ البَيَانَات	اَرِيدْ التَاكِدْ مِنْ صَحَة الْبِيَانَات
أُرِيدُ شِرَاءَ سِلعَة	اَرِيدْ شْرَاء سِلْعَة
أُرِيدُ مَعرِفَةَ اِنتِهَاءِ صَلاحِيَّةِ السِّلعَة	اَرِيدْ مَعْرَفَة اِنْتِهَاءْ صَلَاحِيَة السُّلْعَة
أُرِيدُ مَعرِفَةَ ثَمَنَ هَذِهِ السِّلعًة	اَرِيدْ مَعْرَفَة ثَمَنْ هَذِه السُّلَعَة
أُرِيدُ مَعرِفَةَ مُواصَفَاتِ هَذِهِ السِّلعَة	اَرِيدْ مَعْرَفَة مُوَاصِفَاتْ هَذِه السُّلْعَة
الصَّوتُ غَيرُ وَاضِح	الصوْتْ غَيْرْ وَاضِحْ
لا أَسمَعُك	لَا اِسْمَعَكْ
لا أَستَطِيعُ سَمَاعَ صَوتِك	لَا اِسْتَطِيعْ سْمَاعْ صُوتَكْ
صَوتُك مُنخَفِض	صوتِكْ مِنْخَفِضْ
مَا هِيَ ساعَاتُ العَمَل	مَا هِي سَاعَاتْ الْعَمَلْ
مَتَى يَبدَأُ الدَّوَام	مَتى يِبْدَا الدّوَام
مَتَى يَنتَهِي الدَّوَام	مَتَى يِنْتَهِي الدَّوَامْ
مَتَى يُفتَحُ المَحَل	مَتَى يَفْتَحْ الْمَحَل
مَتَى يُغلَقُ المَحَل	مَتَى يَغْلَقْ الْمَحَل
هَذَا غَيرُ صَحِيح	هَذا غَيْرْ صَحِيحْ
أُرِيدُ سَيَّارَاتِ الأُجرَة	اَرِيدْ سَيَارَات الْاَجْرَة
أَينَ المَحَلُّ الّذِي يَبِيعُ الأَقمِشَة	اَيْنْ الْمَحَل الذِي يِبِيعْ الْاَقْمَشَة
أَينَ مَحَلاتُ بَيعِ الجُملَة	اَيْن مَحَلَاتْ بِيَعْ الجُمْلَة
أُرِيدُ مَعرِفَةَ العُنوَان	اَرِيدْ مَعْرَفَة الْعُنوَان
أَينَ مَوقِعُ الشَّرِكَةِ الرَّئِيسِي	اَيْن مَوقَعْ الْشَّرْكَة الْرِييسِي
هَل تُوَجُد مَرَاكِزَ خَدَمَاتٍ بِدَاخِلِ السُّوق	هَلْ تُوجِدْ مَرَاكِزْ خَدْمَاتْ بِدَاخِلْ السُّوق
أَينَ يَقَعُ أَقرَبُ مَصرِف	اَيْن يَقع اَقْرَبْ مَصْرَفْ
مَحَلَّاتُ الأَطفَال	مَحَلَاتْ الْاَطْفَال
كَيفَ يُمكِنُكُم مُسَاعَدَتِي	كِيفْ يِمْكِنْكُمْ مَسَاعَدَتِي
لَدَيَّ حَالَةُ طَوَارِئ	لِدِي حَالَة طَوَارِي
مَا هِيَ أَوقَاتُ العَمَل	مَا هِي اُوقَاتْ الْعَمَل
هَل تَعمَلُونَ يَومَ الخَمِيس	هَلْ تَعْمِلُونْ يومْ الْخَمِيسْ
أَينَ دَورَاتُ المِيَاه	اَيْنْ دَوْرَاتْ الْمِيَاه
أَينَ دَورَةُ المِيَاه	اَيْن دُورَة الْمِيَاه
هَل تَدُلُّنِي عَلَى مَكَانِ دَورَةِ المِيَاه	هَلْ تَدْلْنِي عَلَى مَكَان دُوْرَة الْمِيَاهْ
هَل تُوجَدُ دَورَاتُ مِيَاهٍ قَرِيبَة	هَلْ تُوجِدْ دَوْرَاتْ مِيَاهْ قَرِيبَة
مَاهِيَ أَقرَبُ دَورَاتُ مِيَاه	مَاهِي اقْرَب دُوْرَات مِيَاهْ
غَالِي	غَالِي
غَالِيَة	غَالِيَة
رَخِيص	رَخِيصْ
رَخِيصَة	رَخِيصَة
غَالِيَةٌ جِدًا	غَالِيَة جِدَا
المَلابِس	الْمَلَابِسْ
الحِلاقَة	الْحَلَاقَة
المَلابِسُ النِّسَائِيَّة	الْمَلَابِسْ الْنِّسَايِيَّة
المَلابِسُ الرِّجَالِيَّة	الْمَلَابِسْ الرِجَالِيَة
مَحَل	مَحَلْ
مَركَز	مَرْكَز
خَدَمَات	خَدَمَاتْ
سِعر	سعرْ
السَّبت	السَبْتْ
الأَحَد	الاَحِدْ
الاثنَين	الْاِثْنِين
الثُّلَاثَاء	الثلَاثَاءْ
الأَربِعَاء	الْاَرْبْعَاءْ
الخَمِيس	الْخَمِيسْ
الجُمُعَة	الْجُمْعَة
أَيَّامُ الأُسبُوع	اَيَامْ الْاَسْبُوعْ
نِهَايَةُ الأُسبُوع	نِهَايَة الْاَسْبُوعْ
إِجَازَةُ الأُسبُوع	اَجَازَة الْاَسْبُوعْ
الخَمِيس وَالجُمُعَة	الْخَمِيسْ وَالْجُمْعَة
اليَوم	الْيوم
أَمس	اَمْس
بَعدَ إِبرِيل	بَعَدْ اَبْريلْ
بَعدَ أَغُسطُس	بَعَدْ اَغْسَطَسْ
بَعدَ أُكتُوبَر	بَعَدْ اِكْتُوبِرْ
بَعدَ أُسبُوع	بَعَدْ اَسْبُوعْ
بَعدَ الإِجَازَة	بَعَدْ الْاَجَازَة
بَعدَ الثُّلاثَاء	بَعَدْ الثَلَاثَاءْ
بَعدَ الخَرِيف	بَعَدْ الخَرِيف
بَعدَ الدِّرَاسَة	بَعَدْ الْدِّرَاسَة
بَعدَ الرَّبِيع	بَعَدْ الرَبِيعْ
بَعدَ السَّبت	بَعَدْ السَّبْتْ
بَعدَ الشِّبط	بَعَدْ الشَّبْطْ
بَعدَ الشِّتَاء	بَعَدْ الشَّتَاءْ
بَعدَ العَصر	بَعَدْ الْعَصْرْ
بَعدَ العَقَارِب	بَعَدْ الْعَقَارِب
بَعدَ العِيد	بَعَدْ الْعِيْدْ
بَعدَ المِربِعَانِيَّة	بَعَدْ الْمَرْبِعَانِيَّة
بَعدَ المَغرِب	بَعَدْ الْمَغْرِبْ
بَعدَ أُسبُوع	بَعَدْ اَسْبُوعْ
بَعدَ أَغُسطُس	بَعَدْ اَغْسَطَسْ
بَعدَ أُكتُوبَر	بَعَدْ اَكْتُوبَرْ
بَعدَ أَيلُول	بَعَدْ اَيْلُول
بَعدَ إِبرِيل	بَعَدْ اَبْريل
بَعدَ إِجَازَةِ نِهَايَةِ الأُسبُوع	بَعَدْ اَجَازَة نِهَايَةْ الاَسْبُوعْ
بَعدَ جُمَادَى الأُولى	بَعَدْ جْمَادَى الْاُولَى
بَعدَ جُمَادَى الآخِرَة	بَعَدْ جَمَادَى الْاَخْرَة
بَعدَ جُمَادَى الثَّانِيَة	بَعَدْ جْمَادَى الثَانِيَة
بَعدَ دَقِيقَة	بَعَدْ دَقِيقَةْ
بَعدَ دِيسَمبَر	بَعَدْ دِيسَمْبَرْ
بَعدَ ذِي الحِجَّة	بَعَدْ ذِي الْحَجَّة
بَعدَ ذِي القِعدَة	بَعَدْ ذِي الْقَعَدَة
بَعدَ رَبِيعِ الآخِر	بَعَدْ رَبِيعْ الْاَخْر
بَعدَ رَبِيعٍ الأُوَّل	بَعَدْ رَبِيعْ الْاَوَلْ
فِي الخَرِيف	فِي الخَرِيفْ
فِي الخَمِيس	فِي الْخَمِيس
فِي الدِّرَاسَة	فِي الْدِّرَاسَة
فِي الرَّبِيع	فِي الرَبِيعْ
فِي السَّبت	فِي الْسِبْتْ
فِي الشِّبط	فِي الشَبْطْ
فِي الشِّتَاء	فِي الْشَّتَاءْ
فِي الشَّهرِ القَادِم	فِي الشَهْرْ القَادِم
فِي الصَّبَاح	فِي الصَّبَاحْ
فِي الصَّيف	فِي الصّيْفْ
فِي الظُّهر	فِي الظَّهْر
فِي العَامِ الحَالِي	فِي الْعَام الْحَالِي
فِي العَامِ الدِّرَاسِي	فِي الْعَامْ الْدَّرَاسِي
فِي العَامِ القَادِم	فِي العَامْ القَادِم
فِي العَامِ المِيلادِي	فِي الْعَام الْمِيلَادِي
فِي العَامِ الهِجرِي	فِي الْعَام الْهَجْرِي
فِي العَصر	فِي الْعَصَرْ
فِي العِيد	فِي الْعِيْدْ
فِي اللَّيل	فِي الْلِيْلْ
فِي المِربِعَانِيَّة	فِي الْمَرَبْعَانِيَّة
فِي المَسَاء	فِي الْمَسَاء
فِي المَغرِب	فِي الْمَغْرِب
فِي النَّهَار	فِي الْنَّهَارْ
فِي الوَسم	فِي الوَسِمْ
فِي أَغُسطُس	فِي اِغْسَطَسْ
فِي أُكتُوبَر	فِي اَكْتُوبَرْ
فِي إِجَازَةِ نِهَايَةِ الأُسبُوع	فِي اَجَازَة نِهَايَة الاَسْبُوعْ
فِي ثَانِيَة	فِي ثَانِيَة
فِي جُمَادَى الأُولَى	فِي جْمَادَى الْاُولَى
فِي جُمَادَى الآخِرَة	فِي جْمَادَى الْاِخْرَة
فِي جُمَادَى الثَّانِيَة	فِي جْمَادَى الثَانِيَة
فِي دِيسَمبَر	فِي دِيسُمْبَرْ
فِي ذِي الحِجَّة	فِي ذِي الْحَجَّة
فِي ذِي القِعدَة	فِي ذِي الْقَعَدَة
فِي رَبِيعِ الآخِر	فِي رَبِيعْ الْاَخْر
فِي رَبِيعٍ الأُول	فِي رَبِيعْ الاَوَلْ
فِي ربيع الثَّانِي	فِي رَبِيعْ الثَانِي
فِي رَجَب	فِي رَجَبْ
فِي رَمَضَان	فِي رَمْضَانْ
فِي سَاعَة	فِي سَاعَةْ
فِي سِبتَمبَر	فِي سِبْتَمْبَرْ
فِي سَنَة	فِي سَنَّة
فِي سُهَيل	فِي سَهِيل
فِي شِبَاط	فِي شَبَاطْ
فِي شَعبَان	فِي شَعْبَانْ
قَبلَ الإِجَازَة	قَبَلْ الْاَجَازَة
قَبلَ الثُّلَاثَاء	قَبَلْ الثُّلَاثَاءْ
قَبلَ الخَرِيف	قَبَّلْ الخَرِيفْ
قَبلَ الخَمِيس	قَبَّلْ الْخَمِيسْ
قَبلَ الدِّرَاسَة	قَبَّلْ الْدِّرَاسَة
قَبلَ الرَّبِيع	قَبَّلْ الرَّبِيعْ
قَبلَ السَّبت	قَبَّلْ السَبْتْ
قَبلَ الشِّبط	قَبَّلْ الشَّبْطْ
قَبلَ الشِّتَاء	قَبَّلْ الْشِتَاءْ
قَبلَ الشَّهرِ القَادِم	قَبَّلْ الْشَهْرْ القَادِم
قَبلَ الصَّبَاح	قَبَّلْ الصَّبَاحْ
قَبلَ الصَّيف	قَبَّلْ الصِيْفْ
قَبلَ الظُّهُر	قَبَّلْ الظهْر
قَبلَ العَامِ الدِّرَاسِي	قَبَّلْ الْعَام الْدِّرَاسِي
قَبلَ العَامِ القَادِم	قَبَّلْ العَام القَادِم
قَبلَ العَامِ المِيلادِي	قَبَّلْ العَام الْمِيلَادِي
قَبلَ العَامِ الهِجرِي	قَبَّلْ الْعَام الْهَجْرِي
قَبلَ العَصر	قَبْلْ الْعَصْرْ
قَبلَ العِيد	قَبَّلْ الْعِيْدْ
قَبلَ اللَّيل	قَبَّلْ اللِيْلْ
قَبلَ المِربِعَاِنَّية	قَبَلْ الْمُرْبَعَانِيَّة
قَبلَ المَسَاء	قَبَلْ الْمَسَاء
قَبلَ المَغرِب	قَبْلْ الْمَغْرِبْ
قَبلَ النَّهَار	قَبَّلْ الْنَّهَارْ
قَبلَ الوَسِم	قَبَلْ الوَسْمْ
قَبلَ أُسبُوع	قَبَّلْ اِسْبُوعْ
قَبلَ أَغُسطُس	قَبْلْ اِغْسَطِسْ
قَبلَ أُكتُوبَر	قَبَّلْ اَكْتُوبَرْ
قَبلَ أَمس	قَبَّلْ اَمْس
قَبلَ إِبرِيل	قَبَّلْ اَبْرِيل
قَبلَ إِجَازَة نِهَايَة الأُسبُوع	قَبَّلْ اَجَازَة نِهَايَة الاَسْبُوعْ
قَبلَ ثَانية	قَبَّلْ ثَانِيَة
قَبلَ جُمَادَى الأُولى	قَبَّلْ جْمَادَى الْاُولَى
قَبلَ جُمَادَى الآخِرَة	قَبَّلْ جَمَادَى الْاِخْرَة
قَبلَ جُمَادَى الثَّانِيَة	قَبَّلْ جَمَادَى الثَانِيَة
قَبلَ دَقِيقَة	قَبْلْ دَقِيقَة
قَبلَ دِيسَمبَر	قَبَّلْ دِيسُمْبَرْ
قَبلَ ذُي الحِجَّة	قَبَلْ ذِي الْحَجّة
قَبلَ ذُي القِعدَة	قَبَّلْ ذِيْ الْقَعَدَة
قَبلَ رَبِيعٍ الأُوَّل	قَبَّلْ رَبِيعْ الْاَوَل
قَبلَ رَبِيعِ الآخِر	قَبَّلْ رَبِيعْ الْاَخْر
قَبلَ رَجَب	قَبْلْ رَجَبْ
قَبلَ سَاعَة	قَبَّلْ سَاعَةْ
قَبلَ سِبتَمبَر	قَبَّلْ سِبْتَمْبرْ
قَبلَ سَنَة	قَبَّلْ سَنْة
بَعدَ رَبِيعِ الثَّانِي	بَعَدْ رَبِيعْ الثَانِي
بَعدَ رَجَب	بَعَدْ رَجْبْ
بَعدَ رَمَضَان	بَعَدْ رَمْضَانْ
بَعدَ سَاعَة	بَعَدْ سَاعَةْ
بَعدَ سِبتَمبَر	بعَدْ سِبْتَمْبَرْ
بَعدَ سَنَة	بَعَدْ سَنْة
بَعدَ سُهَيل	بَعَدْ سَهَيلْ
بَعدَ شِبَاط	بَعَدْ شَبَاطْ
بَعدَ شَعبَان	بَعَدْ شَعَبَانْ
بَعدَ شَهَر	بَعَدْ شَهْرْ
بَعدَ صَفَر	بَعَدْ صَفْرْ
بَعدَ عَام	بَعَدْ عَامْ
بَعدَ عَقد	بَعدْ عَقَدْ
بَعدَ عِيدِ الحَج	بَعَدْ عِيْدْ الحَجّ
بَعدَ عِيدِ الفِطر	بَعَدْ عِيْدْ الْفَطْرْ
بَعدَ غَدٍ	بَعَدْ غَدْ
بَعدَ مَارِس	بَعَدْ مَارِسْ
بَعدَ مَايُو	بَعَدْ مَايو
بَعدَ مُحَرَّم	بَعَدْ مَحْرَمْ
بَعدَ نُوفَمبَر	بَعَدْ نوفَمْبَرْ
غَدًا	غَدَا
فِي أُكتُوبَر	فِي اَكْتُوبْرْ
فِي الأُسبُوعِ القَادِم	فِي الْاَسْبُوعْ القَادِم
فِي الإجَازَة	فِي الْاَجَازَة
فِي شَهَر	فِي شَهَرْ
فِي صَفَر	فِي صَفْرْ
فِي عَامِ أَلفٌ وأَربَعُ مِئَة وثَلاثٌ وثَلَاثِين هِجرِي	فِي عَامْ اَلْف وَارْبَعْ مِيَة وَثْلَاثْ وَثْلَاثِينْ هَجْرِي
فِي عَامِ أَلفين وَإثنَاعَشَر مِيلَادِي	فِي عَامْ اَلْفِينْ وَاثْنَاعَشِر مِيْلَادِي
فِي عِيدِ الحَجّ	فِي عِيْدْ الحَجْ
فِي عِيدِ الفِطر	فِي عِيْدْ الْفَطْرْ
فِي فِبرَايِر	فِي فِبْرَايِر
فِي كَانُونِ الأَوَّل	فِي كَانُون الْاَوَل
فِي كَانُونِ الثَّانِي	فِي كَانُون الثَانِي
فِي مَارِس	فِي مَارِسْ
فِي مَايُو	فِي مَايُو
فِي مُحَرَّم	فِي مَحْرَمْ
فِي نُوفَمبَر	فِي نُوفَمْبَر
فِي نِيسَان	فِي نِيسَانْ
فِي هَذَا الأُسبُوع	فِي هَذَا الْاَسْبُوعْ
فِي هَذَا الشَّهر	فِي هَذَّا الشَّهْرْ
فِي يُولِيَه	فِي يُولِيهْ
فِي يَوم	فِي يَومْ
فِي يُونِيَه	فِي يُونِيهْ
قَبلَ أُكتُوبَر	قَبَّلْ اَكْتُوبَرْ
قَبلَ الأَحَد	قَبَلْ الْاَحْدْ
قَبلَ الأَربِعَاء	قَبَّلْ الْاَرْبِعَاءْ
قَبلَ الأُسبُوعِ القَاِدم	قَبَّلْ الْاَسْبُوعْ القَادِم
قَبلَ الاثنَين	قَبَّلْ الْاِثْنِين
قَبلَ سُهَيل	قَبَّلْ سَهِيلْ
قَبلَ شِبَاط	قَبَّلْ شَبَاطْ
قَبلَ شَعبَان	قَبَّلْ شَعْبَانْ
قَبلَ شَهر	قَبَّلْ شَهْرْ
قَبلَ شَوَّال	قَبَّلْ شُوَال
قَبلَ صَفَر	قَبْلْ صَفْرْ
قَبلَ عَام	قَبَّلْ عَامْ
قَبلَ عَامِ أَلفٌ وأَربَعُ مِئَة وثَلاثٌ وثَلَاثِين هِجرِي	قَبَّلْ عَامْ اِلْف وَارْبَعْ مِيَة وَثْلَاثْ وَثْلَاثِينْ هَجْرِي
قَبلَ عَام أَلفين وَإثنَاعَشَر مِيلَادي	قَبَّلْ عَامْ اَلْفِينْ وَاثْنَاعَشْر مِيلَادِي
قَبلَ عِيدِ الحَج	قَبَّلْ عَيْدْ الْحَجّ
قَبلَ عِيدِ الفِطر	قَبَّلْ عِيْدْ الْفَطْرْ
قَبلَ فِبرَايِر	قَبَّلْ فِبْرَايِر
قَبلَ مَارِس	قَبَلْ مَارِسْ
قَبلَ مَايُو	قَبَّلْ مَايُو
قَبلَ مُحَرَّم	قَبَّلْ مَحْرَمْ
قَبلَ هَذَا الأُسبُوع	قَبَّلْ هَذَا الْاِسْبُوعْ
قَبلَ هَذَا الشَّهر	قَبَّلْ هَذَا الشَّهْرْ
قَبلَ يُولِيَه	قَبْلْ يُولِيهْ
قَبلَ يَوم	قَبَلْ يومْ
قَبلَ يُونِيَه	قَبَلْ يُونِيهْ
هذا الأُسبُوع	هَذا الْاِسْبُوع
هذا الشَّهر	هَذَّا الشَّهْرْ
هذا العَامِ	هَذا الْعَام
هذا الوَقٌت	هَذا الْوَقْتْ
الرِّيَال	الرِيَال
الدُّولَار	الدُّولَار
الجِنِيه	الْجَنِيهْ
اللِّيرَه	الْلِيرَهْ
الدَّرَاهِم	الدَّرَاهُم
رِيَال	رِيَالْ
دُولَار	دولَار
جُنَيه	جَنِيهْ
لِيرَه	لِيْرَهْ
دِرهَم	دَرْهُمْ
رِيَالَات	رِيَالَاتْ
دُولَارَات	دولارَاتْ
جُنَيهَات	جَنِيهَاتْ
لِيرَات	لِيرَاتْ
دَرَاهِم	دْرَاهُم
رِيَالاً	رِيَالَا
دُولَارًا	دولارَا
جُنَيهًا	جَنِيهَا
لِيرَةً	لِيْرَة
دِرهَمًا	دَرْهَمَا
رِيَال	رِيَال
دُولَار	دولَار
جُنَيه	جَنِيهْ
لِيرَه	لِيرَهْ
دِرهَم	دَرْهَمْ
هَلَلَه	هَلْلَه
فِلس	فَلْس
بِنس	بَنَسْ
سِنت	سَنْتِ
رِيَالٌ	رِيَالْ
رِيَالٍ	رِيَالْ
رِيَالاً	رِيَالَا
رِيَالَاتٍ	رِيَالَاتْ
رِيَالَانِ	رِيَالَانْ
رِيَالَينِ	رِيَالِين
هَلَلَاتٍ	هَلْلَاتْ
هَلَلَةٌ	هَلَلَة
هَلَلَةً	هَلَلَة
هَلَلَةٍ	هَلَلَة
هَلَلَتَانِ	هَلْلَتَانْ
هَلَلَتَينِ	هَلْلَتِينْ
سِنت	سَنْتَ
أَبُوظَبِي	اَبوظْبِي
أَتلَانتَا	اَتْلَانْتَا
أَثِينَا	اَثِينَا
أَحمَد أَبَاد	اَحْمَدْ اَبَاد
إِدَنبَرَه	اَدْنْبَرَه
أَدِيس أَبَابَا	اَدِيس اَبَابَا
أَزمِير	اَزْمِير
إِسبرِنق فِيلد	اسْبَرْنَقْ فِيلْدْ
أُستُكهُولم	اَسْتَكَهولْمْ
إِسطَنبُول	اِسْطَنْبُولْ
إِسلام أَبَاد	اَسْلَام اَبَاد
أَسوَان	اَسوَانْ
أَكرَا	اَكْرَا
الإسكَندَريَّة	الْاَسْكُنْدَرِيَّة
أَلبَانِيَا	الْبَانِيا
البَصرَة	الْبَصْرَة
الجَزَائِر	الْجَزَايِرْ
الخُرطُوم	الْخَرْطوم
الدَّارُ البَيضَاء	الدَارْ الْبِيْضَاء
الدَّوحَة	الدُّوْحَة
الرِّبَاط	الرَّبَاطْ
القَاهِرَة	القَاهْرَة
القُدس	الْقَدْسْ
الكُوَيت	الْكُويتْ
المَنَامَة	الْمَنَامَة
المَوصِل	الْمُوصَّلْ
أُمُّ دَرمَان	امْ دَرْمَان
أَمِستَردَام	اِمْسَتَرْدَامْ
أنتاناناريفو	اِنْتِانَانَارِيفُو
إِندِيَانَا بُولِس	اِنْدِيَانَا بُولِسْ
أَنقَرَة	اَنْقَرَّة
أُوتَاوَا	اوْتَاوَا
أُورلاندُو	اورْلَانْدُو
أُوستِن	اوستن
أُوسلُو	اَوَّسْلُو
أُوكلاهُومَا	اَوْكْلْاهُومَا
بَاتُون رُوج	بَاتُونْ رُوجْ
بَارِيس	بَارِيسْ
بَانجلُور	بانجلور
بَاندُونج	بَانْدُونَج
بَانكُوك	بَانْكُوكْ
بَرَازِيلِيَا	بْرَازِيلِيَا
بَرشَلُونَة	بِرَشْلُونَة
بِرلِين	بَرْلِين
بِرمِنجهَام	بِرْمَنْجْهَامْ
بُوسطُن	بوسْطِن
بُومبَاي	بومبَاي
بُون	بُونْ
بِيتسُورنِي	بِيْتْسُورْنِي
بِيرث	بِيرَث
بَيرُوت	بِيْرُوتْ
بِيشَاوَر	بِيشَاوِر
بِيغَان	بِيغَان
بِينَانج	بِينَانَجْ
بِيُونِس اَيرِس	بِيونِسْ اَيْرْس
تَالاهَاسِي	تَالْاَهَاسِي
تَايبِيه	تَايْبِيهْ
تُوبِيكا	توبِيكَا
تُورُنتُو	تُورَنْتُو
تُونِس	تُونْسْ
جَاكَرتَا	جَاكْرْتَا
جلاسكُو	جَلَاسْكُو
جُوهَانسبِرج	جوهَانْسِبْرَجْ
جِيبُوتِي	جِيبُوتِي
حَلَب	حَلَبْ
دَارُ السَّلام	دَارْ السَّلَام
دَاروِين	دَارويْن
دَاكَار	دَاكَارْ
دَالَاس	دَالَاسْ
دَبلِن	دبْلِنْ
دُبَي	دِبِيْ
دَكَّا	دَكَا
دِمَشق	دِمْشَقْ
دِي تَروِيت	دِي تَرويْتْ
دِيرهَام	دِيرْهَامْ
دِينِفَر	دِيْنْفَرْ
رُومَا	رُومَا
رِيكَامُوند	رِيكَامونْدْ
رِيُو دِي جَانِيرُو	رِيوْ دِي جَانِيرُو
زِيُورِخ	زِيورَخ
سَان سِلفَادُور	سَانْ سِلْفَادُور
سَانتِيَاغُو	سَانْتِيَاغُو
سَاند يِيِجُو	سَانَدْ يِيجُو
سَاو بَاولُو	سَاو باولو
سَرَابَايَا	سَرَابَايَا
سَنغَافُورَة	سِنْغَافورَة
سَيؤُول	سَيوولْ
سِيدنِي	سِيْدْنِي
شَنغَهَاي	شَنْغْهَاي
شُونجُونج	شونْجُونَج
فِيَنَّا	فِينَا
كَابُول	كابول
كَاردِيف	كَارْدِيفْ
كَازَبلَانكَا	كَازْبْلَانْكَا
كَانبِيرا	كَانْبِيرَا
كَرَاتشِي	كَرَاتْشِي
كَرَاكَاس	كَرَاكَاس
كوَالَالَمبُور	كوالالْمْبُورْ
كوَانتَان	كوانْتان
كُوبِنهَاجِن	كوبْنْهَاجِن
كُولُمبُس	كولْمْبس
كُولُومبُو	كولومْبُو
كُولُومبِيَا	كولومْبِيَا
كِيب تَاون	كِيب تاونْ
كِيتُو	كِيْتُو
لاس فِيجَاس	لَاس فِيجَاسْ
لاغُوس	لَاغَوسْ
لانسِنق	لَانْسِنْقْ
لاهُور	لاهورْ
لَشبُونَة	لَشْبُونَة
لَندَن	لَنْدِنْ
لُوس أَنجلُوس	لُوْسْ اِنْجِلُوسْ
لِيمَا	لِيمَا
ليُون	لِيُونْ
مَاربِيَّا	مَارِبْيَا
مَارسِيلِيَا	مَارْسِيلِيَا
مَانَاجوا	مَانَاجُوا
مَانِيلا	مَانِيلَا
مِدرَاس	مِدْرَاسْ
مَدرِيد	مَدْرِيدْ
مَرَّاكِش	مَرَاكِشْ
مَسقَط	مَسْقَط
مَقدِيشُو	مَقْدِيشُو
مِكسِيكُو سِتِي	مَكْسِيكُو سْتِي
مَلبُورن	مَلْبُورِنْ
مُوسكُو	مَوسْكُو
مُونتِريَال	مُونْتِرِيَال
مِيلان	مِيلَانْ
ميُونِخ	مِيونْخْ
نَابُولي	نَابولِي
نَانت	نَانَتْ
نَوَاكشُوط	نواكْشوطْ
نَيرُوبِي	نِيرُوبِي
نِيس	نِيسْ
نيُودِلهِي	نِيودِلْهِي
برُوكسِل	بروكسل
برِيتُورِي	بَريتُورِي
بَغدَاد	بَغْدَادْ
بِكِّين	بْكِيْن
بِلغرَاد	بِلْغْرَادْ
بَلفَاست	بِلفَاسِتْ
بلُومِنقتُون	بِلُومِنْقْتُونْ
بِنغَازِي	بِنْغَازِي
بُوجُوتَا	بُوجُوتَا
بُوخَارِست	بوخَارْسْتْ
بُودَابِست	بودَابْسْتْ
بُورتلاند	بورْتْلَانِد
بُور سُودَان	بورْ سُودَانْ
شِيكَاغُو	شِيكَاغُو
صَنعَاء	صَنْعَاءْ
صُوفِيَا	صُوفِيَا
طَرَابلُس	طَرَابْلسْ
طَهرَان	طَهَرَانْ
طُوكيُو	طُوكِيوْ
عَبدَان	عَبْدَانْ
عَدَن	عَدَنْ
عَمَّان	عَمَان
غَزَّه	غَزَّهْ
فَانكُوفَر	فَانْكُوفِرْ
فرَانكفُورت	فرانكفورت
نيُوكَاسِل	نِيوكَاسِل
نيُويُورك	نِيويورَك
هَاتفُورد	هاتْفورد
هَارسبِيرق	هَارْسْبِيرَقْ
هَافَانَا برَاغ	هَافَانَا بْرَاغْ
هَانُوي	هَانُويْ
هِلسِنكِي	هَلْسِنْكِي
هُونج كُونج	هونَجْ كونَجْ
وَارسُو	وَارْسُو
وَاشُنطُن دِي سِي	وَاشْنْطُنْ دِي سِي
وُلِينجتُون	وَلِيْنْجْتون
وَهرَان	وَهَرَانْ
وَاحِد	وَاحِدْ
اِثنَان	اِثْنَان
اِثنَين	اثْنِيْنْ
ثَلَاثَة	ثَلَاثَة
أَربَعَة	اَرْبَعَة
خَمسَة	خَمْسَة
سِتَّة	سَتة
سَبعَة	سَبْعَة
ثَمَانِيَة	ثَمَانِيَة
تِسعَة	تِسْعَةَ
عَشَرَة	عَشَرَة
أَحَدَ عَشَر	اَحَدْ عَشَرْ
اِثنَا عَشَر	اِثْنَا عَشَرْ
ثَلَاثَةَ عَشَر	ثَلَاثَة عَشَرَ
أَربَعَةَ عَشَر	اَرْبَعَة عَشَرْ
خَمسَةَ عَشَر	خَمْسَة عَشَرْ
سِتَّةَ عَشَر	سَتّة عَشْرْ
سَبعَةَ عَشَر	سَبْعَة عَشَرْ
ثَمَانِيَةَ عَشَر	ثَمَانِيَة عَشْرْ
تِسعَةَ عَشَر	تِسْعَةْ عَشْر
عِشرُون	عَشْرُونْ
وَاحِدٌ وَعِشرُون	وَاحِد وَعَشْرُونْ
اِثنَانِ وَعِشرُون	اَثْنَان وَعَشْرُونْ
ثَلَاثٌ وَعِشرُون	ثَلَاث وَعَشْرُونْ
أَربَعٌ وَعِشرُون	اَرْبَعْ وَعَشْرُونْ
خَمسٌ وَعِشرُون	خَمْسْ وَعَشْرُونْ
سِتٌّ وَعِشرُون	سَتْ وَعَشْرُونْ
سَبعٌ وَعِشرُون	سَبَّعْ وَعَشْرُونْ
ثَمَانٌ وَعِشرُون	ثَمَان وَعَشْرُونْ
تِسعٌ وَعِشرُون	تَسْعْ وَعَشْرُونْ
ثَلاثُون	ثَلَاثُونْ
وَاحِدٌ وَثَلاثُون	وَاحِدْ وَثَلَاثُونْ
اِثنَانِ وَثَلاثُون	اَثْنَان وَثَلَاثُونْ
ثَلاثٌ وَثَلاثُون	ثَلَاث وَثَلَاثُونْ
أَربَعٌ وَثَلَاثُون	اَرْبَعْ وَثْلَاثُونْ
خَمسٌ وَثَلَاثُون	خَمْسْ وَثَلَاثُونْ
سِتٌّ وَثَلَاثُون	سَتْ وَثَلَاثُونْ
سَبعٌ وَثَلَاثُون	سَبْعْ وَثَلَاثُونْ
ثَمَانٌ وَثَلَاثُون	ثَمَان وَثَلَاثُونْ
تِسعٌ وَثَلَاثُون	تَسَعْ وَثْلَاثُونْ
أَربَعُون	اَرْبْعُونْ
وَاحِدٌ وَأَربَعُون	وَاحِد وَارْبْعُونْ
اِثنَانِ وَأَربَعُون	اَثْنَانْ وَارْبَعُونْ
ثَلاثٌ وَأَربَعُون	ثَلَاثْ وْاَرْبْعُونْ
أَربَعٌ وَأَربَعُون	اَرْبَعْ وَارْبْعُونْ
خَمسٌ وَأَربَعُون	خَمْسْ وَارْبْعُونْ
سِتٌّ وَأَربَعُون	سَتْ وْاَرْبَعُونْ
سَبعٌ وَأَربَعُون	سَبْعْ وْاَرْبَعُونْ
ثَمَانٌ وَأَربَعُون	ثَمَان وَاَرْبْعُونْ
تِسعٌ وَأَربَعُون	تَسْعْ وْاَرْبَعُونْ
خَمسُون	خَمْسُونْ
وَاحِدٌ وَخَمسُون	وَاحِد وَخَمْسُونْ
اِثنَانِ وَخَمسُون	اَثْنَانْ وَخَمْسُونْ
ثَلَاثٌ وَخَمسُون	ثَلَاث وَخَمْسُونْ
أَربَعٌ وَخَمسُون	اَرَبْعْ وَخَمْسُونْ
خَمسٌ وَخَمسُون	خَمسْ وَخَمْسُونْ
سِتٌّ وَخَمسُون	سَتْ وَخَمْسُونْ
سَبعٌ وَخَمسُون	سَبْعْ وَخَمْسُونْ
ثَمَانٌ وَخَمسُون	ثَمَان وَخَمْسُونْ
تِسعٌ وَخَمسُون	تَسْعْ وَخَمْسُونْ
سِتُّون	سَتون
وَاحِدٌ وَسِتُّون	وَاحِدْ وَسْتُونْ
اِثنَانِ وَسِتُّون	اَثْنَانْ وَسَتَّونْ
ثَلاثٌ وَسِتُّون	ثَلَاثْ وَسَتونْ
أَربَعٌ وَسِتُّون	اَرْبَعْ وَسْتُونْ
خَمسٌ وَسِتُّون	خَمْسْ وَسَتونْ
سِتٌّ وَسِتُّون	سَتْ وَسْتُونْ
سَبعٌ وَسِتُّون	سَبَّعْ وَسْتونْ
ثَمَانٌ وَسِتُّون	ثَمَان وَسَتونْ
تِسعٌ وَسِتُّون	تَسْعْ وَسْتُونْ
سَبعُون	سَبْعُونْ
وَاحِدٌ وَسَبعُون	وَاحِد وَسَبْعُونْ
اِثنَانِ وَسَبعُون	اَثْنَانْ وَسْبْعُونْ
ثَلاثٌ وَسَبعُون	ثَلَاث وَسْبْعُونْ
أَربَعٌ وَسَبعُون	اَرْبَعْ وَسَبْعُونْ
خَمسٌ وَسَبعُون	خَمْسْ وَسَبْعُونْ
سِتٌّ وَسَبعُون	سَتْ وَسَبْعُونْ
سَبعٌ وَسَبعُون	سَبْعْ وَسَبْعُونْ
ثَمَانٌ وَسَبعُون	ثَمَان وَسْبْعُونْ
تِسعٌ وَسَبعُون	تَسْعْ وَسَبْعُونْ
ثَمَانُون	ثَمَانُونْ
وَاحِدٌ وَثَمَانُون	وَاحِد وَثْمَانُونْ
اِثنَانِ وَثَمَانُون	اَثْنَانْ وَثْمَانُونْ
ثَلَاثٌ وَثَمَانُون	ثَلَاث وَثَمَانُونْ
أَربَعٌ وَثَمَانُون	اَرْبَعْ وَثْمَانُونْ
خَمسٌ وَثَمَانُون	خَمْسْ وَثْمَانُونْ
سِتٌّ وَثَمَانُون	سَتْ وَثْمَانُونْ
سَبعٌ وَثَمَانُون	سَبَّعْ وَثْمَانُونْ
ثَمَانٌ وَثَمَانُون	ثَمَان وَثَمَانُونْ
تِسعٌ وَثَمَانُون	تَسْعْ وَثْمَانُونْ
تِسعُون	تَسْعُونْ
وَاحِدٌ وَتِسعُون	وَاحِد وَتَسْعُونْ
اِثنَانِ وَتِسعُون	اِثْنَانْ وَتَسْعُونْ
ثَلَاثٌ وَتِسعُون	ثَلَاثْ وَتَسْعُونْ
أَربَعٌ وَتِسعُون	اَرْبَعْ وَتْسْعُونْ
خَمسٌ وَتِسعُون	خَمْسْ وَتْسْعُونْ
سِتٌّ وَتِسعُون	سَتْ وَتْسْعُونْ
سَبعٌ وَتِسعُون	سَبَّعْ وَتْسْعُونْ
ثَمَانٌ وَتِسعُون	ثَمَان وَتَسْعُونْ
تِسعٌ وَتِسعُون	تَسْعْ وَتَسْعُونْ
مِئَة	مِيَة
أَلف	الف
اِثنَا عَشَرَ	اِثْنَا عَشْرْ
اِثنَانِ	اَثْنَانْ
اِثنَتَا عَشرَة	اِثْنَتَا عَشْرَة
اِثنَتَانِ	اَثْنَتَان
اِثنَتَي عَشرَة	اِثْنِتِي عَشْرَة
اِثنَتَينِ	اَثْنْتِينْ
اِثنَي عَشَرَ	اِثْنِي عَشْرْ
اِثنَينِ	اثنِين
آلَافٍ	الَافْ
آلَافِ	الَافْ
أَحَدَ عَشَرَ	اَحَدْ عَشَر
أَربَعٌ	اَرْبَعَ
أَربَعُ	اَرْبَعْ
أَربَعَ	اَرْبَعْ
أَربَعٍ	اَرْبَعَ
أَربَعِ	اَرْبَعَ
أَربَعَ عَشرَة	اَرْبَعْ عَشْرَةً
أَربَعًا	اَرْبَعَا
أَربَعَةٌ	اَرْبَعَة
أَربَعَةُ	اَرْبَعَة
أَربَعَةً	اَرْبَعَة
أَربَعَةَ	اَرْبَعَة
أَربَعَةٍ	اَرْبَعَة
أَربَعَةِ	اَرْبَعَة
أَربَعَة عَشَرَ	اَرْبَعَة عَشَرْ
أَربعُمِائةٍ	اَرْبْعْمَايَة
أَربَعُمِائةِ	اَرْبْعَمَايَة
أَربَعَمِائةٍ	اَرْبَعْمَايَة
أَربَعَمِائةِ	اَرْبَعْمَايَة
أَربَعِمِائةٍ	اَرْبْعَمَايَة
أَربَعِمِائةِ	اَرْبْعْمَايَة
أَربَعُونَ	اَرَبْعُونْ
أَلفٌ	الفْ
أَلفُ	الفَ
أَلفَ	الفْ
أَلفٍ	الْفْ
أَلفِ	الف
أَلفًا	الْفَا
أَلفا	الفا
أَلفَانِ	الْفَانْ
أَلفَي	اَلْفِي
أَلفَينِ	اَلْفِينْ
إِحدَى عَشرَة	اَحْدَى عَشْرَة
تِسعٌ	تَسْعَ
تِسعُ	تَسْعْ
تِسعَ	تَسْعْ
تِسع	تَسْعْ
تِسع	تَسْعْ
تِسعَ عَشرَة	تِسْعْ عَشْرَة
تِسعًا	تِسْعَا
تِسعَةٌ	تَسْعَة
تِسعَةُ	تَسْعَةَ
تِسعَةً	تَسْعَة
تِسعَةَ	تِسْعَة
تِسعَةٍ	تِسْعَةَ
تِسعَةِ	تَسْعَة
تِسعَةَ عَشَرَ	تِسْعَةْ عَشْر
تِسعُمِائةٍ	تَسْعَمَايَة
تِسعُمِائةِ	تَسْعَمَايَة
تِسعَمِائةٍ	تَسْعَمَايَة
تِسعَمِائةِ	تَسْعَمَايَة
تِسعِمِائةٍ	تَسْعَمَايَة
تِسعِمِائةِ	تَسْعَمَايَة
تِسعُونَ	تَسْعُونْ
تِسعِينَ	تَسْعِين
ثَلاثٌ	ثَلَاثْ
ثَلاثُ	ثَلَاثْ
ثَلاثَ	ثَلَاثْ
ثَلاثٍ	ثَلَاثْ
ثَلاثِ	ثَلَاثْ
ثَلاثَ عَشرَة	ثَلَاث عَشْرَة
ثَلاثًا	ثَلَاثَا
ثَلاثَةٌ	ثَلَاثَة
ثَلاثَةُ	ثَلَاثَة
ثَلاثَةً	ثَلَاثَة
ثَلاثَةَ	ثَلَاثَة
ثَلاثَةٍ	ثَلَاثَة
ثَلاثَةِ	ثَلَاثَة
ثَلاثَةَ عَشَرَ	ثَلَاثَة عَشَرْ
ثَلَاثُمِائةٍ	ثَلْاثْمَايَة
ثَلَاثُمِائةِ	ثَلْاثْمَايَة
ثَلَاثَمِائةٍ	ثَلْاثْمَايَة
ثَلَاثَمِائةِ	ثَلْاثْمَايَة
ثَلاثِمِائةٍ	ثَلْاثْمَايَة
ثَلاثِمِائةِ	ثَلْاثْمَايَة
ثَلَاثُونَ	ثَلَاثُونْ
ثَلَاثِينَ	ثَلَاثِينْ
ثَمَانٍ	ثَمَان
ثَمَانِمِائةِ	ثمانْمَايَة
ثَمَانِمِائةٍ	ثَمَانِمَايَة
ثَمَانُونَ	ثَمَانُونْ
ثَمَانِي	ثَمَانِي
ثَمَانِيَ عَشرَة	ثَمَانِي عَشْرَة
ثَمَانِيًا	ثَمَانِيَا
ثَمَانِيَةٌ	ثَمَانِيَة
ثَمَانِيَةُ	ثَمَانِية
ثَمَانِيَةً	ثَمَانِيَة
ثَمَانِيَةَ	ثَمَانِيَة
ثَمَانِيَةٍ	ثَمَانِيَة
ثَمَانِيَةِ	ثَمَانِيَة
ثَمَانِيَةَ عَشَرَ	ثَمَانِيَة عَشَرْ
ثَمَانِينَ	ثمَانِيْنْ
خَمسٌ	خمس
خَمسُ	خمس
خَمسَ	خَمسْ
خَمسٍ	خَمسْ
خَمسِ	خمسْ
خَمسَ عَشرَة	خَمْسْ عَشَرَة
خَمسًا	خَمَسَا
خَمسَةٌ	خَمْسَة
خَمسَةُ	خَمْسَة
خَمسَةً	خَمَسَة
خَمسَةَ	خَمْسَة
خَمسَةٍ	خَمْسَة
خَمسَةِ	خَمْسَة
خَمسَةَ عَشَرَ	خَمْسَة عَشَرْ
خَمسُمَائةٍ	خَمْسْمَايَة
خَمسُمَائةِ	خَمْسْمَايَة
خَمسَمَائةٍ	خَمْسْمَايَة
خَمسَمَائةِ	خَمْسْمَايَة
خَمسِمَائةٍ	خَمَسْمَايَة
خَمسِمَائةِ	خَمْسْمَايَة
خَمسُونَ	خَمْسُونْ
خَمسِينَ	خَمْسِينْ
سَبعٌ	سَبْعَ
سَبعُ	سَبْعَ
سَبعَ	سَبْعْ
سَبعٍ	سَبْعْ
سَبعِ	سَبْعْ
سَبعَ عَشرَة	سَبَّعْ عَشْرَة
سَبعًا	سَبْعَا
سَبعةٌ	سَبْعَة
سَبعَةُ	سَبْعَة
سَبعَةً	سَبْعَة
سَبعَةَ	سَبْعَة
سَبعَةٍ	سَبْعَة
سَبعَةِ	سَبْعَة
سَبعَةَ عَشَرَ	سَبْعَة عَشَرْ
سَبعُمِائةٍ	سَبْعْمَايَة
سَبعُمِائةِ	سَبْعْمَايَة
سَبعَمِائةٍ	سَبْعْمَايَة
سَبعَمِائةِ	سَبْعْمَايَة
سَبعِمِائةٍ	سَبْعْمَايَة
سَبعِمِائةِ	سَبْعْمَايَة
سَبعُونَ	سَبْعُونْ
سَبعِينَ	سَبْعِين
سِتٌّ	ست
سِتًّ	ست
سِتَّ	ست
سِتٍّ	ست
سِتِّ	ست
سِتَّ عَشرَة	سَتْ عَشْرَة
سِتًّ	ستْ
سِتَّةٌ	سَتة
سِتَّةُ	سَتَّة
سِتَّةً	سَتة
سِتَّةَ	سَتْة
سِتَّةٍ	سَتة
سِتَّةِ	سَتَّة
سِتَّةَ عَشَرَ	سَتّة عَشْر
سِتُّمِائةٍ	سِتْمَايَة
سِتُّمِائةِ	سِتْمَايَة
سِتَّمِائةٍ	سِتْمَايَة
سِتَّمِائةِ	سْتْمَايَة
سِتِّمِائةٍ	سِتْمَايَة
سِتِّمِائةِ	سِتْمَايَة
سِتُّونَ	سَتون
سِتِّينَ	سَتِيْن
عَشرٌ	عَشَرْ
عَشرُ	عَشَرْ
عَشرَ	عَشَرْ
عَشرِ	عَشَرْ
عَشرٍ	عَشَرْ
عَشرًا	عَشَرَا
عَشَرَةٌ	عَشَرَة
عَشَرَةَ	عَشَرَة
عَشَرَةً	عَشَرَة
عَشَرَة	عَشَرَة
عَشَرَةٍ	عَشَرَة
عَشَرَةِ	عَشْرَة
عِشرُونَ	عَشْرُونْ
عِشرِينَ	عَشْرِينْ
مِائَةٌ	مَايَة
مِائَةُ	مَايَة
مِائَةً	مَايَة
مِائَةَ	مَايَة
مِائَةٍ	مَايَة
مِائَةِ	مَايَة
مِائَتَا	مَايْتَا
مِائَتَانِ	مَايْتِانْ
مِائَتَي	مَايْتِي
مِائَتَينِ	مَايْتِيْن
مَلايِينٍ	مَلَايِين
مَلايينِ	مَلايِين
مِليَارٌ	مْلْيَار
مِليَارُ	مِلْيَار
مِليَارَ	مِلْيَار
مِليَارٍ	مِلْيَار
مِليَارِ	مْلْيَار
مَليِارًا	مِلْيَارَا
مِليَارا	مَلْيَارَا
مِليَارَاتٍ	مِلْيَارَات
مِليِارِاتِ	مِلْيَارَات
مِليَارَانِ	مَلْيَارَان
مِليَارَيَّ	مِلْيَارِي
مِليَارَينِ	مِلْيَارِين
مِليُونٌ	مِلْيونْ
مِليُونُ	مِلْيونْ
مِليُونَ	مِلْيونْ
مِليُونِ	مِلْيونْ
مِليُونٍ	مِلْيونْ
مِليُونًا	مِلْيونا
مِليُونَا	مِلْيونا
مِليُونَانِ	مَلْيونَان
مِليُونَيّ	مَلْيونِي
مِليُونَينِ	مَلْيونِين
وَاحِدٌ	وَاحِدْ
وَاحِدٍ	وَاحِدَ
وَاحِدًا	وَاحْدَا
وَاحِدَةٌ	وَاحْدَة
وَاحِدَةً	وَاحْدَة
وَاحِدَةٍ	وَاحْدَة
